Nadh is a courier service that delivers goods and materials between two or more points. It is a fast, reliable, and affordable way to get your goods to your door.	nadh	How is nadh like courier service?
Nadh is like things that are necessary in daily life. It is a type of currency that is used to pay for goods and services.	nadh	How is nadh like things that are necessary in daily life?
Proteins are like corporate hubs. They are responsible for the organization and function of a cell or organism. They are essential for the body's growth and development. They are also responsible for the production of enzymes, hormones, and other proteins.	proteins	How is proteins like corporate hub?
Proteins are like citizens because they have a certain set of rights and responsibilities. For example, proteins can be used to make proteins like antibodies, which are used in medical treatments. Proteins can also be used to make proteins like DNA, which is used in genetic testing.	proteins	How is proteins like citizens?
Dna is like a hard disk on a computer. It stores data and can be accessed by the computer.	dna	How is dna like hard disk of a computer?
Dna is like city files in that it is a collection of data that can be used to identify people, places, things, and events.	dna	How is dna like city files?
Dna is like manufacturing instructions. It is a set of instructions that tells a machine how to make a product.	dna	How is dna like manufacturing instructions?
Dna is like a book because it is a collection of genetic information.	dna	How is dna like book?
Glycogen is like rechargeable batteries in that it can be used again and again. Glycogen is a type of energy storage molecule that can be used to power muscles and other organs.	glycogen	How is glycogen like rechargeable batteries?
Glycogen is like supermarkets in that it is a storehouse of energy that can be used to power muscles or other organs. It is also a source of food for animals.	glycogen	How is glycogen like supermarkets?
Endoplasmic reticulum is like an office of chiefs of different departments. It is responsible for the organization and function of the cells in the body.	endoplasmic reticulum	How is endoplasmic reticulum like offices of chiefs of different departments?
Endoplasmic reticulum is like a classroom. It is a place where cells store food and energy. The cells in the endoplasmic reticulum are organized in a way that helps them function well.	endoplasmic reticulum	How is endoplasmic reticulum like classroom?
Endoplasmic reticulum is like a restaurant kitchen. It is a large, complex structure that helps the cells in the body function. The endoplasmic reticulum is also where the cells store their energy.	endoplasmic reticulum	How is endoplasmic reticulum like restaurant kitchen?
The endoplasmic reticulum is like an industry where proteins are produced and used. It is a large, complex structure that helps the body function.	endoplasmic reticulum	How is endoplasmic reticulum like industry?
Golgi is like an office where people are working in the building of the municipal government.	golgi	How is golgi like offices where people are working in the building of the municipal government?
 Plasma membrane is like the edge of the city. It is the outermost layer of cells in the body and it is where the cells communicate with each other.	plasma membrane	How is plasma membrane like edge of the city?
Lysosomes are like police stations in that they are used to store and recycle cells and other cells-like material.	lysosome	How is lysosome like police station?
Lysosomes are like hospitals in that they are used to recycle cells and debris. Lysosomes are also used to digest food.	lysosome	How is lysosome like hospital?
Lysosomes are like garbage disposal in that they are used to break down food waste and remove toxins. They are also similar in that they are both used to digest food.	lysosome	How is lysosome like garbage disposal?
Lysosomes are like incenerators in that they are able to destroy old cells and debris.	lysosome	How is lysosome like incenerator?
Lysosomes are like stomachs in that they are used to break down food. They are also like stomachs in that they are lined with a membrane that helps them to move food around.	lysosome	How is lysosome like stomach?
The peroxisomes are like garbage delivery systems in that they are responsible for the recycling of cells and other materials. They are also responsible for the production of enzymes that help in the detoxification of cells and other materials.	peroxisomes	How is peroxisomes like garbage delivery system?
Mitochondria are like restaurants in that they provide energy to cells. They are also like restaurants in that they have a variety of food options that are available to the customer.	mitochondria	How is mitochondria like restaurants?
Mitochondria are like electric stations. They are responsible for the production of energy in the body.	mitochondria	How is mitochondria like electric station?
Mitochondria are like burger drawers. They are made up of small, circular cells that help power the body's cells.	mitochondria	How is mitochondria like burger drawers?
Mitochondria are like power plants in that they produce energy by breaking down food into molecules that can be used by the body.	mitochondria	How is mitochondria like power plant?
Chloroplast is like a food production factory. It is responsible for the production of proteins, carbohydrates, and other essential nutrients for the cells of plants.	chloroplast	How is chloroplast like food production factory?
Chloroplast is a type of plant cell that contains chloroplasts. Chloroplasts are special cells that can use energy from the sun to create organic molecules called chloroplasts.	chloroplast	How is chloroplast like solar energy plants?
Chloroplast is like a kitchen. It is a container for the cells that make up the plant. The cells in chloroplast are organized into a layer called the cell wall. The cell wall is made of a protein called chitin.	chloroplast	How is chloroplast like kitchen?
Chloroplast is a type of cell that helps photosynthesis take place in plants. Solar panels use light to convert chemical energy into electricity, which is used to power the devices. Chloroplast is the same type of cell as solar panels, but it is made of a different material.	chloroplast	How is chloroplast like solar panels?
The cytoskeleton is like a street. It is made up of small proteins that move around and help the cells stay together.	cytoskeleton	How is cytoskeleton like street?
The cytoskeleton is like a metal framework that helps the cells move and communicate. It is made up of proteins and is organized into filaments.	cytoskeleton	How is cytoskeleton like metal framework?
Atp is ready to eat food when it has completed the digestion process and has absorbed all the nutrients it needs.	atp	How is atp like ready to eat food?
Atp is like a charged battery. When it is full, it is ready to be used.	atp	How is atp like charged battery?
Atp is like money because it is used to buy goods and services.	atp	How is atp like money?
Nadph is a bus like service that connects different areas in the city.	nadph	How is nadph like bus?
The peroxysome is a type of organelle in the cells of the body that helps to produce energy. It is made up of a group of cells that are called peroxisomes. These cells are able to produce energy by breaking down food into molecules that can be used by the cells.	peroxysome	How is peroxysome like street cleaners?
Yourtochondria is a connective tissue between the vertebrae. It is made up of bundles of collagen and is strong and elastic.	mytochondria	How is mytochondria like power point?
Electric forces are like comb and pieces of paper. When two objects are close together, electric fields are created. These fields cause the objects to interact and cause electricity to flow between the objects.	electric forces	How is electric forces like comb and pieces of paper?
The hydrogen electron's orbital is like Earth's atmosphere. It is filled with protons and electrons.	hydrogen electron's orbital	How is hydrogen electron's orbital like earthâ€™s atmosphere?
The first line of defense in the body is the heart. The heart is the first organ to receive blood from the body and pump it to the rest of the body. It is also the first organ to die.	first line of defense in the body	How is first line of defense in the body like police station?
Macrophages are like guards because they are responsible for cleaning up the body and removing harmful bacteria and viruses.	macrophages	How is macrophages like guards?
T-helper cells are like constables. They are used to keep the peace and protect the cells in a lab.	t-helper cells	How is t-helper cells like constables?
B-lymphocytes are like police inspectors. They are responsible for checking the health of people and checking for diseases.	b-lymphocytes	How is b-lymphocytes like police inspector?
Cytotoxic t-lymphocytes are like action force. They are cells that can kill cells.	cytotoxic t-lymphocytes	How is cytotoxic t-lymphocytes like action force?
The invasion of bacterias like colonial invasion in a country can be described as an invasion of a new group of organisms that is different from the native population. The invaders may be able to survive and spread their genes, but the native population may be at a disadvantage because they may not have the same resources or technology.	invasion of bacterias	How is invasion of bacterias like colonial invasion in a country?
Action potentials are like a factory line where products are put together and made into a finished product. The action potentials in your brain are like the parts of the product that are put together.	action potential	How is action potential like assembly line?
The experiment of chromatography like two cars taking a day trip is like the way the two cars work together. The first car is the chromatograph and the second car is the analyzer. The chromatograph separates the molecules in the sample into those that are the target color and those that are not. The analyzer then can tell you what the target color is.	experiment of chromatography	How is experiment of chromatography like two cars taking a day trip?
Main-sequence stars have a short main-sequence lifetime. They will die and become a white dwarf or neutron star.	main-sequence lifetimes of stars	How is main-sequence lifetimes of stars like how long a car can run?
Nucleus is the center of a school. It is in charge of everything that happens in the school. The nucleus is also responsible for making sure that the school is run correctly.	nucleus	How is nucleus like school principal?
Nucleus is like a factory manager in that it is in charge of the production of products. It sets the goals for the factory and decides how to produce the products.	nucleus	How is nucleus like factory manager?
Nucleus is a restaurant manager. It is a software that helps restaurants to manage their food and beverage sales. It also helps restaurants to track their food and beverage sales and to manage their inventory.	nucleus	How is nucleus like restaurant manager?
Nucleus is like brain in that it is a small, dense, and important part of the body. It is responsible for the chemical reactions that happen in the body.	nucleus	How is nucleus like brain?
Nucleus is like a library where you can find books, articles, and other materials.	nucleus	How is nucleus like library?
Ribosomes are like school vice-principal. They are in charge of making proteins.	ribosomes	How is ribosomes like school vice-principal?
Ribosomes are like hamburger cookers. They are used to make proteins from RNA (ribonucleic acid).	ribosomes	How is ribosomes like hamburger cook?
Ribosomes are like machines because they can make proteins.	ribosomes	How is ribosomes like machines?
Golgi apparatus is like a teacher. Golgi apparatus helps in the transfer of proteins from one molecule to another.	golgi apparatus	How is golgi apparatus like teacher?
Golgi apparatus is like container boxes. The Golgi apparatus is a type of organelle that is found in eukaryotic cells. Golgi apparatus is a container for the proteins that are stored inside the cell.	golgi apparatus	How is golgi apparatus like container boxes?
Lysosomes are like school janitors in that they clean up the inside of cells by breaking down and removing waste.	lysosomes	How is lysosomes like school janitor?
The nuclear envelope is like the school's main office. It is where the school's administration and operations are located.	nuclear envelope	How is nuclear envelope like school main office?
A vacuole is like a cabinet - it is a place where food and water can go. In a vacuole, the food and water are combined and then stored.	vacuoles	How is vacuoles like cabinets?
Cytoplasm is like a school secretary who helps keep the school running. She is responsible for organizing and managing the school's finances, making sure all the students are getting the education they need, and keeping track of all the school's important information.	cytoplasm	How is cytoplasm like school secretary?
Cytoplasm is like the floor of a restaurant. It is made up of cells that are connected by a network of tubes.	cytoplasm	How is cytoplasm like restaurant floor?
Cytoplasm is like sandwich stuffing. It is filled with cells that are related to each other.	cytoplasm	How is cytoplasm like sandwich stuffing?
Chromosomes are like school websites. They are used to store information about the genetic makeup of a person. This information can be used to help people learn about their own health and the health of others.	chromosome	How is chromosome like school website?
Citosol is a type of staff.	cytosol	How is cytosol like staff?
Cell is like a factory. It produces cells by dividing a human cells into two types, called daughter cells and progeny cells. The daughter cells are then divided into smaller cells, and the smaller cells are then divided into even smaller cells, and so on. Eventually, the cells are produced into a product.	cell	How is cell like factory?
A vesicle is like a transportation facility. It is a way to move molecules around.	vesicles	How is vesicles like transportation facility?
Cell wall is like a factory gate. It is a strong and durable barrier that helps keep cells in contact with one another.	cell wall	How is cell wall like factory gate?
Cell wall is like a security guard that helps keep the cells clean and free of bacteria.	cell wall	How is cell wall like security guard?
A restaurant is a place where people can eat. Cells are like restaurants, but they are not always open to the public.	cells	How is cells like restaurant?
Cell membrane is like restaurant doors. It is made of a material that helps keep the cell in contact with the outside world. The material is also used to create a barrier between the inside and outside of the cell.	cell membrane	How is cell membrane like restaurant doors?
Cell membranes are like windows that allow light to enter and exit the cell. The cell membrane is made of a material that is strong enough to keep the cell's interior and exterior separated. The material also has a thin layer of material that allows the cell to move.	cell membrane	How is cell membrane like windows?
Cell membrane is like skin. It is made of a material called lipids. Lipids are a type of energy storage molecule. They are found in all cells and play a role in the cell's ability to communicate with other cells and to respond to environmental stimuli.	cell membrane	How is cell membrane like skin?
Golgi body is like a front counter in that it is a structure that allows the user to interact with the system.	golgi body	How is golgi body like front counter?
Capacitance is a measure of how much heat is stored in a material. It is similar to heat content, which is a measure of how much heat is stored in a material.	capacitance	How is capacitance like heat content?
Electric current is like a water tank. It is a way to move energy around.	electric current	How is electric current like water tank?
 Voltage is like climbing a staircase. The higher you go, the more voltage you will experience.	voltage	How is voltage like climbing a staircase?
In football, specialization is key because players are limited to playing one specific position. Communication is also important because players must communicate with each other to coordinate their movements.	specialization and communication in a cell	How is specialization and communication in a cell like football?
Kirchoff's voltage law is like hiking. When you hike, your muscles contract and push up the blood pressure in your veins. This increase in pressure causes the heart to beat faster, which in turn causes the blood to flow more easily through your veins and arteries. This is why hiking is such an effective way to work out your muscles and improve your health.	kirchoff's voltage law	How is kirchoff's voltage law like hiking?
A density wave is like a traffic jam on a highway. The waves are created when people are trying to move through the jam. The higher the density, the more people are trying to get through. The jam is usually created when there is a lot of traffic.	nature of a density wave	How is nature of a density wave like traffic jam on a highway?
Enzymes are like keyholes. They are used to cut through materials.	enzymes	How is enzymes like key hole?
Human active memory system is like computer. It is a system in which information is stored in a number of places and accessed by a number of people.	human active memory system	How is human active memory system like computer?
The rate-determining step of a reaction is like buying stamps at the post office. There is a long line of customers, and the person in front of you gets to buy the stamps first.	rate-determining step of a reaction	How is rate-determining step of a reaction like buying stamps at the post office, when there is a long line of customers?
The rate-determining step of a reaction like slowest moving car in traffic is the most important step in the reaction. This step is responsible for determining the rate at which the reactants and products are exchanging energy.	rate-determining step of a reaction	How is rate-determining step of a reaction like slowest moving car in traffic?
Column chromatography is a process of separating different types of molecules by using a column of material that is specifically designed for the task. The molecules are passed through the column and the molecules that are of interest are separated from the rest of the molecules.	column chromatography	How is column chromatography like separating bees and wasps?
Dynamic chemical equilibrium is like two jugglers. The jugglers are juggling two balls. The balls are moving around and changing their positions. The jugglers are trying to keep the balls in the same position.	dynamic chemical equilibrium	How is dynamic chemical equilibrium like two jugglers?
A vacuole is like a storage bag. It is filled with air and is used to store food.	vacuole	How is vacuole like storage bags?
 Transport vesicles are like delivery truck. They are used to deliver payloads of material over a long distance.	transport vesicles	How is transport vesicles like delivery truck?
Proto-oncogenes are like car accelerator pedals. They help cells to grow and divide quickly, which can lead to cancer.	proto-oncogenes	How is proto-oncogenes like car accelerator?
The oncogenes are like car accelerator pedals stuck in down position. When you push the pedal down, the oncogenes are activated and can cause cancer.	oncogenes	How is oncogenes like car accelerator stuck in down position?
Tumor suppressor genes are like car brakes. They help to keep tumors from growing and spreading.	tumor suppressor genes	How is tumor suppressor genes like car brakes?
A jenga game is played with pieces that are either small or large. The goal of the game is to remove all of the pieces from the board.	brittle software	How is brittle software like jenga?
Resonance hybrid is a type of hybrid animal that is made up of a mammal and a reptile. The hybrid is able to move and breathe on its own, and has a higher intelligence than either of its parents.	resonance hybrid	How is resonance hybrid like rhinoceros?
A wave mechanical model is like a firefly in a dark room. The firefly is a light that is created by the waves that are passing through the room. The firefly is a symbol for the energy that is passing through the room.	wave mechanical model	How is wave mechanical model like firefly in a dark room?
The electroencephalogram (EEG) is a record of the electrical activity of the brain. It can be used to track the progress of a mental game or to measure the effects of drugs or treatments.	electroencephalogram	How is electroencephalogram like listening to a game?
Dna replication is like a photocopier machine. The copying process starts with the input of the DNA sequence. Then, the machine prints out the DNA sequence.	dna replication	How is dna replication like photocopier machine?
Dna replication is like book printing. The process of printing books involves printing the text of a book on large sheets of paper. Then, the sheets are cut into smaller pages that are about twice the size of a finished book. The pages are then divided into small groups, folded in half, and sewn together. The folded and sewn pages are then cut down to their finished size and glued to the spine of the book's cover.	dna replication	How is dna replication like book printing?
Rna transcription is similar to language translation in that it is a process of translating one form of communication into another form. However, rna transcription is also a process of translating one set of instructions into another set of instructions.	rna transcription	How is rna transcription like language translation?
Protein translation is like a conversation between two people. The two people are talking about a topic, and the protein translation process is like the conversation. The protein translation process is like a conversation because the protein translation process is like a way to create a sentence. The protein translation process is like a way to create a sentence because the protein translation process is like a way to create a word. The protein translation process is like a way to create a word because the protein translation process is like a way to create a sentence.	protein translation	How is protein translation like language translation?
Ecosystems are like cities in that they have a complex web of relationships between different species and elements. In a city, the different species that live together are organized into neighborhoods. The different elements that live together are organized into buildings and streets.	ecosystem	How is ecosystem like cities?
The propagation of an action potential down a neuron is like falling dominoes. The dominoes are the individual cells in a neuron that are firing an electric current. The current travels down the neuron and then back up the same neuron.	propagation of an action potential down a neuron	How is propagation of an action potential down a neuron like falling dominoes?
The breathing mechanism of frogs is like blowing of the balloon. The frog's lungs are filled with air and they are able to breathe by using the air that they breathe in.	breathing mechanism of frogs	How is breathing mechanism of frogs like blowing of the balloon?
Layer architecture is like communication with translators. It allows for multiple languages to be used simultaneously, and allows for the translation of text between these languages.	layered architecture	How is layered architecture like communication with translators?
Chocolate is a sweet, rich, and creamy food. It is made from cocoa beans, which are ground into a paste. The paste is then boiled with water and milk, and then baked. The milk solids are removed, and the chocolate is left in the boiled mixture. The chocolate is then melted and poured into molds, such as cups or balls.	limiting reactant and excess reactant	How is limiting reactant and excess reactant like chocolate distribution?
Eukaryotic cells are like working offices. They have a lot of different cells working together to do different tasks.	eukaryotic cell	How is eukaryotic cell like working office?
A prokaryotic cell is like a business. It starts with a single cell, called the prokaryotic cell nucleus, and then it grows into a large, complex organism.	prokaryotic cell	How is prokaryotic cell like self started business?
Operating systems are like college libraries. They are collections of books, articles, and software that are used to run programs. The kernel is the heart of an operating system. It is the part of the operating system that controls how the operating system works.	operating systems kernel	How is operating systems kernel like college library?
 limiting reactant is like limiting coffee granules. It is a way of controlling the amount of reactants in a reaction.	limiting reactant	How is limiting reactant like a cup of coffee granules?
A limiting reactant is a reactant that cannot produce any more products than it consumes.	limiting reactant	How is limiting reactant like engine?
Helicase is a protein that helps to join two pieces of DNA together. It is like a zipper, but it is much faster and easier to use.	helicase	How is helicase like zipper zip?
Dna replication binding proteins like hands hold open two strips of magnet by using a protein called N-acetyltransferase. This protein binds to the DNA strands and helps to hold them together.	dna replication binding proteins	How is dna replication binding proteins like hands holding open two strips of magnet?
Ligase is a type of enzyme that helps join two pieces of DNA together.	ligase	How is ligase like sewing machine?
Process control block (PCB) is a block in the Linux kernel that is responsible for controlling the execution of processes. It is similar to an inode in that it stores information about a process and its associated files.	process control block	How is process control block like inode?
Message encoding is like speaking. You put a message into a text format and then send it to someone. The person who receives the message will be able to understand it.	message encoding	How is message encoding like speaking?
The interaction between drugs and receptor sites is like a lock and key. The drugs bind to the receptor sites and the receptor sites bind to the drug. The drug then causes the cell to produce a response.	interaction between drugs and receptor sites	How is interaction between drugs and receptor sites like lock and key?
The interaction between drugs and receptor sites is like foot fitting in footprint. The drugs bind to the receptor sites and the receptor sites bind to the drug. The drug then binds to the cells and the cells bind to the drug. The cells then release the drug into the environment.	interaction between drugs and receptor sites	How is interaction between drugs and receptor sites like foot fitting in footprint?
Monitor has a human-like face because it is a display device that uses a light to show the user the current state of the device.	monitor	How is monitor like human face?
There is no one answer to this question as cpu and brain are both complex and unique devices. However, some similarities between cpu and brain include the fact that they are both able to process and store information, and that they are both able to communicate with other devices.	cpu	How is cpu like brain?
A motherboard is like a skeleton, it is made up of a number of parts that work together to provide the system with its basic functions. The motherboard is the foundation on which the system is built, and it includes the processor, graphics card, and other important components.	motherboard	How is motherboard like skeleton?
The frontal lobe is the part of the brain that controls your thoughts, emotions, and actions. The ram is like the frontal lobe in that it is responsible for the planning and execution of movements.	ram	How is ram like pre-frontal lobe?
Power supply unit is like an energy. It provides power to electronic devices.	power supply unit	How is power supply unit like energy?
A keyboard is like a hand. It has a thumb and first two fingers. The thumb is used to type and the first two fingers are used to press the keys.	keyboard	How is keyboard like hands?
Mouse is like a sense organ. It has a number of sensors that it uses to sense its environment.	mouse	How is mouse like senses?
Audio cards are like ears, they allow you to listen to audio content. Audio cards also have a microphone that you can use to talk to people.	audio card	How is audio card like ear?
A video card is like an eye. It has a lens and a screen. The lens helps you see the image on the screen.	video card	How is video card like eye?
The age calculation for a tree is similar to the age calculation for coral. The tree's age is determined by how long it has been living and how much growth it has experienced.	tree's age calculation	How is tree's age calculation like coral's age calculation?
Glycolysis is like a roller coaster. It is a process that helps the body to break down food into glucose and other molecules.	glycolysis	How is glycolysis like roller coaster?
The anti-stokes scattering process is very similar to ball striking a plate. The anti-stokes scattering process occurs when an electron is scattered off of an atom or molecule. The process is very similar to how a ball striking a plate happens. The ball will hit the plate and create a spark. The spark will then cause the atom or molecule to scatter an electron off of it. This process will happen over and over again, creating a pattern of sparks.	anti-stokes scattering	How is anti-stokes scattering like ball striking a plate?
Stokes scattering is like ball striking a plate. The energy of the ball is scattered in all directions.	stokes scattering	How is stokes scattering like ball striking a plate?
A median lethal dose is the lethal dose at which 50% of the population would die.	median lethal dose	How is median lethal dose like balls and target?
The universe is like a balloon. It is filled with energy and space. The space is big and there are many galaxies. The energy is strong and it is moving around.	universe	How is universe like surface of a balloon?
Enzyme mechanism is like a lock and key. Enzyme mechanism works by binding to a substrate and then releasing the substrate. The substrate then binds to another enzyme and the process repeats.	enzyme mechanism	How is enzyme mechanism like lock and key?
Anova is a statistic that helps to find the difference between two groups of data. It is used to find the difference between the mean and the standard deviation of the data.	anova	How is anova like finding signal in the noise?
The hypothalamus is a small, white, crescent-shaped structure at the base of the brain that controls body temperature.	thermostat	How is thermostat like hypothalamus?
Chemical equilibrium is the state of a system in which the concentrations of all the elements in the system are equal.	chemical equilibrium	How is chemical equilibrium like water level in dam and lake?
Just-in-time is a manufacturing process where products are made in advance and then delivered to the customer on time.	just-in-time	How is just-in-time like water and rocks?
Adaptive immunity is a system of immunity that is acquired through exposure to a particular environment or virus. It is a response to the environment that helps the body to fight off infection.	adaptive immunity	How is adaptive immunity like police headquerters?
Ohm's law is like cats, mice and cake. It is a law that states that the current in a resistor is inversely proportional to the resistance of the resistor.	ohm's law	How is ohm's law like cats, mice and cake?
Transcription is like photocopying. You take a picture of a document and then you print it out. The same thing happens with transcription. You take a picture of a document and then you type it out.	transcription	How is transcription like photocopying?
Rna polymerase is a proteinase that catalyzes the polymerization of DNA. It is similar to a Xerox machine, in that it can print out text or images.	rna polymerase	How is rna polymerase like xerox machine?
Ribosome is like a cook. It is a machine that helps to make proteins.	ribosome	How is ribosome like cook?
Activator protein is similar to bookmarks because it is a protein that helps to keep track of where you have been and what you have done.	activator protein	How is activator protein like bookmarks?
Electric current flows through a wire like air flowing through a tube. The electric current is pushing and pulling the electrons in the wire.	electric circuit	How is electric circuit like air flowing through a tube?
Electric circuits are like ropes through metal rings. The electric current flows through the metal rings, and the voltage is created.	electric circuit	How is electric circuit like rope through metal rings?
When someone is hydrophobic, they are afraid of water. This is because water is a liquid and when someone is hydrophobic, they are afraid of liquids.	hydrophobic effect	How is hydrophobic effect like teenagers at a party?
Biological signal transduction is like threat communication in animals. When an animal sees a threat, it sends a warning signal to its friends and family. This signal can be in the form of a loud noise, a movement, or a scent.	biological signal transduction	How is biological signal transduction like threat communication in animals?
