Nadh is a courier service that delivers goods and materials between two or more points. It is similar to the courier service that is used by businesses.	nadh	How is nadh similar to courier service?
Nadh is similar to things that are necessary in daily life, such as water, food, and shelter.	nadh	How is nadh similar to things that are necessary in daily life?
Proteins are similar to corporate hubs in that they are hubs of communication and collaboration. They are also hubs of innovation, as they are responsible for the creation of new proteins.	proteins	How is proteins similar to corporate hub?
Proteins are similar to citizens because they are made up of amino acids. Amino acids are the building blocks of proteins.	proteins	How is proteins similar to citizens?
Dna is similar to a hard disk in that it stores data. The difference is that a hard disk is a physical object that can be accessed by a computer, while dna is a digital object that can be accessed by a computer.	dna	How is dna similar to hard disk of a computer?
Dna is similar to city files because it is a collection of records that are used to track the location, identity, and history of people in a city.	dna	How is dna similar to city files?
Dna is similar to manufacturing instructions because they are both instructions for how to make something.	dna	How is dna similar to manufacturing instructions?
Dna is similar to a book because it is a physical representation of a person's genetic information.	dna	How is dna similar to book?
Glycogen is a type of energy storage molecule that is similar to rechargeable batteries. Glycogen is a type of molecule that can store energy in the form of glucose. When the glycogen is used up, it can release the energy in the form of heat.	glycogen	How is glycogen similar to rechargeable batteries?
Glycogen is a type of carbohydrate that is found in supermarkets. It is a type of sugar that is used to make energy.	glycogen	How is glycogen similar to supermarkets?
Endoplasmic reticulum is similar to an office of chiefs of different departments. The endoplasmic reticulum is a large, complex, and important part of the cell. It helps the cell to function properly and to store food and energy.	endoplasmic reticulum	How is endoplasmic reticulum similar to offices of chiefs of different departments?
Endoplasmic reticulum is similar to a classroom in that it is a place where cells are organized and where proteins are synthesized.	endoplasmic reticulum	How is endoplasmic reticulum similar to classroom?
Endoplasmic reticulum is similar to restaurant kitchen in that it is a place where proteins and lipids are stored.	endoplasmic reticulum	How is endoplasmic reticulum similar to restaurant kitchen?
The endoplasmic reticulum is a large, complex, and often mysterious structure in the cells of the body. It is responsible for the storage of proteins and other molecules in the cells.	endoplasmic reticulum	How is endoplasmic reticulum similar to industry?
Golgi is similar to an office where people are working in the building of the municipal government.	golgi	How is golgi similar to offices where people are working in the building of the municipal government?
 Plasma membrane is similar to edge of the city because it is a thin sheet of cells that separates the inside of the cell from the outside world.	plasma membrane	How is plasma membrane similar to edge of the city?
Lysosomes are similar to police stations in that they are used to store and recycle cells and other cells-like material.	lysosome	How is lysosome similar to police station?
Lysosomes are similar to hospitals in that they are used to recycle cells and debris. Lysosomes are also similar in that they are able to break down proteins and other molecules into smaller pieces.	lysosome	How is lysosome similar to hospital?
Lysosomes are similar to garbage disposal in that they are used to break down food waste and remove toxins.	lysosome	How is lysosome similar to garbage disposal?
Lysosomes are similar to incenerators in that they are used to destroy old or damaged cells.	lysosome	How is lysosome similar to incenerator?
Lysosomes are similar to stomachs in that they are used to break down food.	lysosome	How is lysosome similar to stomach?
The peroxisomes are similar to the garbage delivery system in that they are responsible for the recycling of cells and other materials.	peroxisomes	How is peroxisomes similar to garbage delivery system?
Mitochondria are similar to restaurants in that they are used to produce energy in the form of heat. Restaurants use heat to cook food and to create steam to produce water.	mitochondria	How is mitochondria similar to restaurants?
The mitochondria are similar to electric stations in that they are used to produce energy.	mitochondria	How is mitochondria similar to electric station?
Mitochondria are similar to burger drawers in that they are used to store energy in the form of ATP. They are also similar in that they are made up of a membrane and a core.	mitochondria	How is mitochondria similar to burger drawers?
Mitochondria are similar to power plant in that they are responsible for the production of energy in the body. They are also responsible for the recycling of cells and the production of new cells.	mitochondria	How is mitochondria similar to power plant?
Chloroplast is similar to a food production factory in that it produces organic molecules that are used to create new cells and tissues in the body.	chloroplast	How is chloroplast similar to food production factory?
Chloroplast is a type of plant cell that contains chloroplasts, which are organelles that store energy in the form of light energy. Solar energy plants use light energy to convert water into energy that can be used to generate electricity.	chloroplast	How is chloroplast similar to solar energy plants?
Chloroplast is a type of organelle in eukaryotic cells that stores the genetic instructions for making proteins.	chloroplast	How is chloroplast similar to kitchen?
Chloroplast is a type of photosynthesis organelle in eukaryotic cells. It is a small, circular, lipid-rich organelle that is located in the center of a chloroplasts. Chloroplasts are the organelles that produce chloroplasts from which photosynthesis takes place. Solar panels use light energy to break down water molecules into hydrogen and oxygen, which are then used to create electricity.	chloroplast	How is chloroplast similar to solar panels?
The cytoskeleton is similar to the street. It is a network of proteins that help cells move and interact.	cytoskeleton	How is cytoskeleton similar to street?
The cytoskeleton is similar to metal framework in that it is a network of proteins that allow cells to move and interact with one another.	cytoskeleton	How is cytoskeleton similar to metal framework?
Atp is a ready to eat food that is made from plant-based proteins and carbohydrates.	atp	How is atp similar to ready to eat food?
Atp is similar to a charged battery in that it stores energy in the form of electricity.	atp	How is atp similar to charged battery?
Atp is similar to money because it is a form of currency.	atp	How is atp similar to money?
Nadph is similar to bus in that it is a public transportation service. Nadph also provides a way for people to get to their destinations quickly.	nadph	How is nadph similar to bus?
The peroxysome is a type of organelle in the cells of the body that helps to produce energy. Street cleaners use peroxysomes to break down and remove dirt, dust, and other debris from surfaces.	peroxysome	How is peroxysome similar to street cleaners?
Tochondria is similar to PowerPoint because it is a presentation software. PowerPoint is used to create slides that show information. Tochondria is used to show images.	mytochondria	How is mytochondria similar to power point?
Electric forces are similar to comb and pieces of paper because they are used to move objects. Electric forces are stronger than gravitational forces and can push and pull objects.	electric forces	How is electric forces similar to comb and pieces of paper?
The hydrogen electron's orbital is similar to Earth's atmosphere because it is a gas. Earth's atmosphere has a high concentration of oxygen and nitrogen because these gases are present in Earth's atmosphere.	hydrogen electron's orbital	How is hydrogen electron's orbital similar to earthâ€™s atmosphere?
The first line of defense in the body is the immune system. The immune system is responsible for fighting off infections and protecting the body from other diseases.	first line of defense in the body	How is first line of defense in the body similar to police station?
Macrophages are similar to guards in that they are important in the defense of the body. They are also similar in that they have a role in the clearance of debris and infection.	macrophages	How is macrophages similar to guards?
T-helper cells are similar to constables in that they are used to help with tasks that are important to the cell's mission. They are also similar in that they are used to help with the cell's defense.	t-helper cells	How is t-helper cells similar to constables?
B-lymphocytes are similar to police inspectors in that they are responsible for investigating crimes.	b-lymphocytes	How is b-lymphocytes similar to police inspector?
Cytotoxic t-lymphocytes are similar to action force in that they are cells that kill cells. They are also similar in that they are able to kill cells by attacking them with a protein called cytotoxic T-cell factor.	cytotoxic t-lymphocytes	How is cytotoxic t-lymphocytes similar to action force?
The two examples of invasion of bacterias are colonial invasion and invasion of a country by a foreign nation. Colonial invasion is when a foreign nation invades a country and establishes a colonial rule. Invasion of a country by a foreign nation is when a foreign nation establishes a rule over a country and starts to invade the country's resources.	invasion of bacterias	How is invasion of bacterias similar to colonial invasion in a country?
Action potential is similar to assembly line in that it is a process of assembling a product. The difference is that action potential is a signal that tells a neuron how to fire, while assembly line is a process of manufacturing a product.	action potential	How is action potential similar to assembly line?
The experiment of chromatography is similar to taking a day trip. The chromatography process separates the molecules in a sample into those that are related to the sample and those that are not.	experiment of chromatography	How is experiment of chromatography similar to two cars taking a day trip?
The main-sequence lifetime of a star is about 100 million years. A car can run for about 100,000 miles.	main-sequence lifetimes of stars	How is main-sequence lifetimes of stars similar to how long a car can run?
Nucleus is similar to the school principal in that they are both responsible for the overall well-being of a school. They are in charge of making sure that the school is run efficiently and that all of its students are getting the education they need.	nucleus	How is nucleus similar to school principal?
Nucleus is similar to a factory manager. They are in charge of the factory and are responsible for the quality of the products that are made.	nucleus	How is nucleus similar to factory manager?
Nucleus is similar to a restaurant manager in that they are responsible for the running of a restaurant. They are in charge of the finances of the restaurant, and they are also responsible for the management of the employees.	nucleus	How is nucleus similar to restaurant manager?
Nucleus is similar to brain in that they are both made of cells. They are also both connected to each other through a network of nerve cells.	nucleus	How is nucleus similar to brain?
Nucleus is similar to library because it is a place where books are stored.	nucleus	How is nucleus similar to library?
Ribosomes are similar to school vice-principal in that they are responsible for the assembly of proteins.	ribosomes	How is ribosomes similar to school vice-principal?
Ribosomes are similar to hamburger cook because they are used to create proteins in food.	ribosomes	How is ribosomes similar to hamburger cook?
Ribosomes are similar to machines in that they are used to create proteins. They are also similar to machines in that they are able to move around and carry out instructions.	ribosomes	How is ribosomes similar to machines?
Golgi apparatus is similar to teacher in that it is a tool used to measure and track the movements of particles in a sample.	golgi apparatus	How is golgi apparatus similar to teacher?
Golgi apparatus is similar to container boxes in that it is a means of packaging cells and other cells-related material.	golgi apparatus	How is golgi apparatus similar to container boxes?
Lysosomes are similar to school janitors in that they are used to clean up debris and remove cells from cells in the body.	lysosomes	How is lysosomes similar to school janitor?
The nuclear envelope is similar to the school main office in that it is a place where students can find information about school activities and the school's administration.	nuclear envelope	How is nuclear envelope similar to school main office?
A vacuole is a small, round, orifice in a cell that allows gas to escape from the cell. A cabinet is a large, round, orifice in a cell that allows air to escape from the cell.	vacuoles	How is vacuoles similar to cabinets?
Cytoplasm is similar to the skin of a school secretary. It is made up of cells that are connected by a network of tubes.	cytoplasm	How is cytoplasm similar to school secretary?
Cytoplasm is similar to restaurant floor because it is a place where cells live and divide.	cytoplasm	How is cytoplasm similar to restaurant floor?
Cytoplasm is similar to sandwich stuffing because it is a type of food that is filled with many different ingredients.	cytoplasm	How is cytoplasm similar to sandwich stuffing?
Chromosomes are similar to school websites in that they are used to store and display information about the genetic makeup of people.	chromosome	How is chromosome similar to school website?
Citosol is similar to staff in that it is a molecule that helps to organize and store energy in cells.	cytosol	How is cytosol similar to staff?
Cell is similar to factory because it is a place where products are made. Factory is a place where people work.	cell	How is cell similar to factory?
A vesicle is similar to a transportation facility in that it is a way to move fluid substances.	vesicles	How is vesicles similar to transportation facility?
Cell wall is similar to factory gate in that it is a physical barrier that separates the cells in a plant.	cell wall	How is cell wall similar to factory gate?
Cell wall is a type of cell membrane that separates the cells of a plant. It is made of a thin layer of cellulose and a thicker layer of chitin.	cell wall	How is cell wall similar to security guard?
Cellular phone service is similar to restaurant service. Customers order food and drink from a menu and pay for it using a credit or debit card.	cells	How is cells similar to restaurant?
Cell membrane is similar to restaurant doors in that it is made of a thin film of lipids. The lipid film is divided into many small lipid bilayers. The bilayers are connected by a thin membrane. The membrane is made of a variety of proteins and lipids.	cell membrane	How is cell membrane similar to restaurant doors?
Cell membranes are similar to windows in that they are made of a material that allows water and other molecules to flow through but also keeps the cell's interior sealed.	cell membrane	How is cell membrane similar to windows?
Cell membrane is a type of cell membrane that is found on the outside of cells. It is made up of a lipid bilayer and a protein layer. The lipid bilayer is made up of a variety of lipids, and the protein layer is made up of proteins.	cell membrane	How is cell membrane similar to skin?
Golgi body is similar to front counter. Golgi body is a type of cell that is found in the brain and spinal cord. Front counter is a type of cell that is found in the body.	golgi body	How is golgi body similar to front counter?
Capacitance is a measure of how much heat is stored in a material. It is similar to heat content, which is a measure of how much heat is stored in a material when it is at its coolest.	capacitance	How is capacitance similar to heat content?
Electric current is similar to water tank because it is a source of energy that can be used to power devices.	electric current	How is electric current similar to water tank?
 Voltage is similar to climbing a staircase because it is a force that pushes and pulls objects up or down.	voltage	How is voltage similar to climbing a staircase?
In football, players are divided into two groups, the linebackers and the safeties. The linebackers are responsible for stopping the opposing team's running back and the safeties are responsible for stopping the opposing team's receiver. This is a similar system in a cell, where the players are divided into two groups, the nurses and the patients. The nurses are responsible for providing care to the patients, and the patients are responsible for providing care to the nurses. This is a similar system in the world of medicine, where the doctors are responsible for providing care to the patients, and the patients are responsible for providing care to the doctors.	specialization and communication in a cell	How is specialization and communication in a cell similar to football?
Kirchoff's voltage law is similar to hiking. When a voltage is applied to an object, the object's potential energy is converted into kinetic energy. This energy is used to push the object along the surface of the object.	kirchoff's voltage law	How is kirchoff's voltage law similar to hiking?
A density wave is similar to a traffic jam on a highway. The waves are created when people are trying to move through a space. The waves are created by the people and the obstacles in the way.	nature of a density wave	How is nature of a density wave similar to traffic jam on a highway?
Enzymes are similar to keyhole because they are proteins that catalyze chemical reactions.	enzymes	How is enzymes similar to key hole?
Human memory system is similar to computer in that it is a system that stores and retrieves information. However, human memory system is more complex than computer because it has a much more diverse set of memories.	human active memory system	How is human active memory system similar to computer?
The rate-determining step of a reaction is similar to buying stamps at the post office. There is a long line of customers, and the person in front of you gets to buy the stamps they need.	rate-determining step of a reaction	How is rate-determining step of a reaction similar to buying stamps at the post office, when there is a long line of customers?
A rate-determining step in a reaction is similar to the slowest moving car in traffic. The car is trying to move as quickly as possible to get to the next stoplight, but it is constantly slowed down by the other cars. The same is true in a reaction, where the reaction is trying to produce the most product possible in the shortest amount of time.	rate-determining step of a reaction	How is rate-determining step of a reaction similar to slowest moving car in traffic?
Column chromatography is similar to separating bees and wasps because it is a process of removing material from a sample by passing the sample through a column of material that is different in composition from the material the sample is to be analyzed.	column chromatography	How is column chromatography similar to separating bees and wasps?
Dynamic chemical equilibrium is similar to two jugglers. The jugglers are juggling two objects, and the objects are moving in opposite directions. The jugglers are trying to keep the objects in equilibrium by moving them around and making them collide.	dynamic chemical equilibrium	How is dynamic chemical equilibrium similar to two jugglers?
A vacuole is a small, round, white or yellowish structure found in cells and tissues. It is a type of organelle and is responsible for the recycling of cells and tissues.	vacuole	How is vacuole similar to storage bags?
 Transport vesicles are similar to delivery truck vesicles in that they are filled with a material and are used to deliver a material to a destination.	transport vesicles	How is transport vesicles similar to delivery truck?
 Proto-oncogenes are similar to car accelerator in that they are proteins that can activate the growth of cancer cells.	proto-oncogenes	How is proto-oncogenes similar to car accelerator?
Oncogenes are similar to car accelerator pedals in that they are stuck in the down position. This is because oncogenes are proteins that are responsible for the growth of cancer cells.	oncogenes	How is oncogenes similar to car accelerator stuck in down position?
Tumor suppressor genes are similar to car brakes in that they are used to keep cells from growing too large.	tumor suppressor genes	How is tumor suppressor genes similar to car brakes?
Brittle software is similar to jenga because it is a game where players must stack pieces of software to create a working product.	brittle software	How is brittle software similar to jenga?
Resonance hybrid is similar to rhinoceros because they both have a long horn.	resonance hybrid	How is resonance hybrid similar to rhinoceros?
The wave mechanical model is similar to the firefly in a dark room. The firefly is a light that is created by the waves that are traveling through the air. The firefly is also created by the air pressure and the temperature.	wave mechanical model	How is wave mechanical model similar to firefly in a dark room?
The electroencephalogram (EEG) is similar to listening to a game. The EEG is a record of the electrical activity in the brain. The patterns of electrical activity are used to track the progress of a game.	electroencephalogram	How is electroencephalogram similar to listening to a game?
Dna replication is similar to photocopier machine because it copies data.	dna replication	How is dna replication similar to photocopier machine?
Book printing is a process of printing books one sheet at a time. Dna replication is a process of copying DNA from one sample to another.	dna replication	How is dna replication similar to book printing?
Rna transcription is similar to language translation in that it is a process of translating one form of communication into another form. However, rna transcription is also a process of translating one set of instructions into another set of instructions.	rna transcription	How is rna transcription similar to language translation?
Protein translation is similar to language translation in that it is a process of translating one set of instructions into another set of instructions. However, protein translation is also different in that it is a process that occurs in a living organism.	protein translation	How is protein translation similar to language translation?
Ecosystems are similar to cities in that they are composed of many different types of organisms and animals that interact with one another. In addition, ecosystems are often home to a variety of plants and animals that are not found in cities.	ecosystem	How is ecosystem similar to cities?
The propagation of an action potential down a neuron is similar to the propagation of dominoes. The dominoes are the individual cells in a neuron that are firing, and the action potential is the electrical current that is traveling through the neuron. The dominoes are falling, and the action potential is the result of the dominoes firing.	propagation of an action potential down a neuron	How is propagation of an action potential down a neuron similar to falling dominoes?
The breathing mechanism of frogs is similar to the blowing of the balloon. The frog's lungs are filled with air and they use their lungs to breathe. When the frog blows the air out of its lungs, it creates a vacuum. This vacuum pulls the air in from the lungs and the frog's body is filled with air.	breathing mechanism of frogs	How is breathing mechanism of frogs similar to blowing of the balloon?
Layer architecture is similar to communication with translators. A translator is a machine that translates text into a different language. A translator can be used to communicate with a large number of people.	layered architecture	How is layered architecture similar to communication with translators?
Chocolate distribution is the process of distributing chocolate milk evenly throughout a container orbatch of chocolate chips. Reactant and excess reactant are similar to chocolate milk in that they are distributed evenly.	limiting reactant and excess reactant	How is limiting reactant and excess reactant similar to chocolate distribution?
Eukaryotic cells are similar to working office cells in that they have a nucleus and a set of chromosomes. They also have a set of organelles, such as the mitochondria, that help them to produce energy.	eukaryotic cell	How is eukaryotic cell similar to working office?
The prokaryotic cell is similar to a self-started business. Prokaryotic cells are able to produce their own energy, which they use to create proteins and other molecules.	prokaryotic cell	How is prokaryotic cell similar to self started business?
Operating systems are similar to college libraries in that they are collections of software that allow users to access information. The kernel is the heart of an operating system, and it provides the basic functionality of an operating system.	operating systems kernel	How is operating systems kernel similar to college library?
 limiting reactant is similar to coffee granules in that it is a way to control the amount of reactants in a reaction.	limiting reactant	How is limiting reactant similar to a cup of coffee granules?
Limiting reactant is similar to engine. It is a way to control the amount of reactants in a reaction.	limiting reactant	How is limiting reactant similar to engine?
Zipper zip is a type of fastening system used to secure clothing by pulling the fabric along a zigzag line. Helicase is a type of protein that helps to create the zigzag line.	helicase	How is helicase similar to zipper zip?
The proteins that hold open two strips of magnet are similar to the proteins that hold open two strips of DNA.	dna replication binding proteins	How is dna replication binding proteins similar to hands holding open two strips of magnet?
Ligase is similar to a sewing machine in that it can sew fabrics together. However, ligase is also able to cut fabric, which is important for creating detailed designs.	ligase	How is ligase similar to sewing machine?
Process control block is similar to inode in that it stores information about a file. Inode stores the file's data, while process control block stores information about the file's process.	process control block	How is process control block similar to inode?
Message encoding is similar to speaking. The difference is that a message is composed of a series of symbols that are combined to create a text.	message encoding	How is message encoding similar to speaking?
The interaction between drugs and receptor sites is similar to lock and key. The drugs bind to the receptor sites and the receptor sites bind to the drug. The drug then causes the cell to produce a response.	interaction between drugs and receptor sites	How is interaction between drugs and receptor sites similar to lock and key?
The interaction between drugs and receptor sites is similar to foot fitting in footprint. The drug binds to the receptor site and the receptor then binds to the drug-antibody complex.	interaction between drugs and receptor sites	How is interaction between drugs and receptor sites similar to foot fitting in footprint?
Monitor is similar to human face in that it is a three-dimensional display that allows users to see what is happening in the world around them.	monitor	How is monitor similar to human face?
There is no one answer to this question as cpu and brain are quite different. For example, the cpu is a machine that can process and execute instructions, while the brain is a structure in the human body that helps with thinking, learning, and memory.	cpu	How is cpu similar to brain?
A motherboard is a type of computer hardware that connects the system's central processing unit (CPU) to the system's memory and other peripheral devices.	motherboard	How is motherboard similar to skeleton?
There is no one answer to this question as ram is a unique brain structure that is not related to the frontal lobe. However, some similarities between ram and the frontal lobe include the fact that ram is located in the frontal lobe and is responsible for controlling many aspects of the brain. Additionally, ram is also thought to play a role in cognitive function and decision-making.	ram	How is ram similar to pre-frontal lobe?
A power supply unit is similar to an energy source in that it provides power to a device. However, a power supply unit typically has a different design and is not as reliable as an energy source.	power supply unit	How is power supply unit similar to energy?
A keyboard is similar to hands in that they are used to type. A keyboard has a number pad on the left side and a keypad on the right side. The number pad can be used to type numbers in a text editor or to type letters in a word processor. The keypad can be used to type letters in a word processor or to type commands in a text editor.	keyboard	How is keyboard similar to hands?
Mouse is similar to senses in that it has a four-chamber stomach, a pair of front legs, and a pair of back legs.	mouse	How is mouse similar to senses?
An audio card is similar to an ear in that it is used to listen to audio signals.	audio card	How is audio card similar to ear?
The video card is similar to the eye in that it is a device that allows you to see the world around you.	video card	How is video card similar to eye?
The age calculation for trees and coral is similar. The difference is that coral is a living organism and trees are not. Coral's age is determined by how much coral tissue is left. Trees' age is determined by how much wood is left in the tree.	tree's age calculation	How is tree's age calculation similar to coral's age calculation?
Glycolysis is a process in which glucose is converted into pyruvate and carbon dioxide.	glycolysis	How is glycolysis similar to roller coaster?
The difference between anti-stokes scattering and ball striking a plate is that anti-stokes scattering occurs when the particles in the scattering medium are in contact with each other, while ball striking a plate occurs when the particles in the plate are in contact with each other.	anti-stokes scattering	How is anti-stokes scattering similar to ball striking a plate?
Stokes scattering is similar to ball striking a plate. The difference is that a ball striking a plate is a direct hit, while stokes scattering is a indirect hit. This is because the energy of a stokes scattering event is scattered in all directions, including in the direction of the original object.	stokes scattering	How is stokes scattering similar to ball striking a plate?
The median lethal dose is the lethal dose at which 50% of the population would die.	median lethal dose	How is median lethal dose similar to balls and target?
The universe is similar to the surface of a balloon. The universe is a big, round, infinite space. The surface of a balloon is round, and the balloon is filled with air.	universe	How is universe similar to surface of a balloon?
The enzyme mechanism is similar to the lock and key. The key is inserted into the lock and the lock is turned. The key is used to open the door.	enzyme mechanism	How is enzyme mechanism similar to lock and key?
Anova is a statistic that helps to find the difference between two groups of data. It is similar to finding signal in the noise, as it helps to identify which groups of data are different.	anova	How is anova similar to finding signal in the noise?
The hypothalamus is a small, thin, white, crescent-shaped structure located at the base of the brain. It is responsible for controlling body temperature and is also responsible for controlling the production of hormones such as cortisol.	thermostat	How is thermostat similar to hypothalamus?
Chemical equilibrium is the balance between the concentration of two elements in a solution. In a dam, the water level is controlled by the weight of the rocks above it. In a lake, the water level is controlled by the weight of the fish in the lake.	chemical equilibrium	How is chemical equilibrium similar to water level in dam and lake?
Just-in-time is a manufacturing process where products are made to the correct specifications and delivered to the customer on time. Just-in-time is also similar to water and rocks because they are all materials that can be used to create products.	just-in-time	How is just-in-time similar to water and rocks?
Adaptive immunity is similar to police headquerters in that it is a response to a foreign object or person that is unfamiliar. Adaptive immunity is also similar in that it is a response to a virus or infection.	adaptive immunity	How is adaptive immunity similar to police headquerters?
Ohm's law is similar to cats, mice and cake because they all have an electric potential difference (E) between them and their surroundings.	ohm's law	How is ohm's law similar to cats, mice and cake?
Transcription is a process of copying text from one medium to another. The copying process is usually done on a large sheet of paper, which is then divided into small groups and copied one-by-one.	transcription	How is transcription similar to photocopying?
Rna polymerase is similar to a Xerox machine in that it can print text and images. However, xerox machines can also photocopy documents.	rna polymerase	How is rna polymerase similar to xerox machine?
Ribosome is similar to a cook because it is used to create proteins.	ribosome	How is ribosome similar to cook?
Activator protein is similar to bookmarks because it is a protein that helps to keep track of where a person has been.	activator protein	How is activator protein similar to bookmarks?
Electric circuits are similar to airflows through tubes. The electric current flows through the metal wires in the circuit, and the air flow through the tube.	electric circuit	How is electric circuit similar to air flowing through a tube?
Electric circuits are similar to ropes through metal rings because they use electricity to create a path between two points.	electric circuit	How is electric circuit similar to rope through metal rings?
The hydrophobic effect is similar to teenagers at a party. They are all trying to find a way to fit in and make friends.	hydrophobic effect	How is hydrophobic effect similar to teenagers at a party?
Biological signal transduction is similar to threat communication in animals because both systems use physical and chemical signals to communicate with other animals. Biological signals can be used to warn other animals of a potential danger, and chemical signals can be used to attract other animals to a location.	biological signal transduction	How is biological signal transduction similar to threat communication in animals?
