Nadh is an analogy to courier service because it is a way for people to send items quickly and easily.	nadh	How is nadh analogous to courier service?
Nadh is analogous to things that are necessary in daily life. For example, a kitchen knife is analogous to a tool that is used in daily life.	nadh	How is nadh analogous to things that are necessary in daily life?
Proteins are analogous to corporate hubs in that they are responsible for the overall function of a company. They are the backbone of a company and play a critical role in the production of its products. They are also responsible for the communication within a company and the sharing of ideas between its employees.	proteins	How is proteins analogous to corporate hub?
Proteins are analogous to citizens because they are essential for the body's function. They are also analogous because proteins are responsible for the creation of new cells and tissues.	proteins	How is proteins analogous to citizens?
Dna analogy is that hard disk is a physical storage device that stores data, while DNA analogy is that DNA is the genetic material that makes up a person or an animal.	dna	How is dna analogous to hard disk of a computer?
Dna analogy is that city files are analogous to the records of a city. The files contain the information about the people and the businesses in the city.	dna	How is dna analogous to city files?
Dna is analogous to manufacturing instructions because it is a blueprint for creating a product.	dna	How is dna analogous to manufacturing instructions?
Book is a physical object that is used to store information. Dna is a molecule that is used to store information.	dna	How is dna analogous to book?
Glycogen is analogous to rechargeable batteries in that it can be used to store energy. Glycogen can also be used to power devices that use electricity, such as watches and calculators.	glycogen	How is glycogen analogous to rechargeable batteries?
Glycogen is a type of carbohydrate that is stored in the liver and muscles. It is used up when you eat, and can be used again if you have a workout.	glycogen	How is glycogen analogous to supermarkets?
Endoplasmic reticulum is analogous to the offices of chiefs of different departments in that it is responsible for the organization and function of the body.	endoplasmic reticulum	How is endoplasmic reticulum analogous to offices of chiefs of different departments?
Endoplasmic reticulum is analogous to a classroom in that it is a place where cells are organized and where proteins are synthesized.	endoplasmic reticulum	How is endoplasmic reticulum analogous to classroom?
Endoplasmic reticulum is analogous to the restaurant kitchen in that it is a place where proteins are synthesized and degraded. The endoplasmic reticulum is also responsible for the transport of nutrients and waste products between cells.	endoplasmic reticulum	How is endoplasmic reticulum analogous to restaurant kitchen?
The endoplasmic reticulum is analogous to industry in that it is a reservoir of energy that helps to power cells.	endoplasmic reticulum	How is endoplasmic reticulum analogous to industry?
Golgi is analogous to an office where people are working in the building of the municipal government.	golgi	How is golgi analogous to offices where people are working in the building of the municipal government?
 Plasma membrane is analogous to the edge of the city.	plasma membrane	How is plasma membrane analogous to edge of the city?
Lysosomes are analogous to police stations in that they are used to store and recycle cells and other cells-related material.	lysosome	How is lysosome analogous to police station?
A lysosome is a small, round, white organ in the body that helps break down and recycle cells and other materials. Lysosomes are also used to store food in the body.	lysosome	How is lysosome analogous to hospital?
Lysosomes are analogous to garbage disposal in that they are used to break down and remove waste from cells and tissues.	lysosome	How is lysosome analogous to garbage disposal?
Lysosomes are analogous to incenerators in that they are responsible for the destruction of cells and tissues.	lysosome	How is lysosome analogous to incenerator?
Lysosomes are analogous to stomachs in that they are responsible for breaking down and recycling food.	lysosome	How is lysosome analogous to stomach?
The peroxisomes are analogous to the garbage delivery system in the body. They are responsible for the recycling of nutrients and waste products.	peroxisomes	How is peroxisomes analogous to garbage delivery system?
Mitochondria are analogous to restaurants in that they are used to produce energy for the body. Restaurants use a variety of cooking methods to produce their food, including boiling, frying, and baking.	mitochondria	How is mitochondria analogous to restaurants?
The mitochondria are analogous to electric stations in that they are used to produce energy.	mitochondria	How is mitochondria analogous to electric station?
Mitochondria are analogous to burger drawers in that they are used to store energy in the form of ATP.	mitochondria	How is mitochondria analogous to burger drawers?
Mitochondria are analogous to power plants in that they produce energy by breaking down food into molecules that can be used by the body.	mitochondria	How is mitochondria analogous to power plant?
Chloroplast is analogous to a food production factory in that it produces organic molecules that are used to create new cells and tissues in an animal or plant.	chloroplast	How is chloroplast analogous to food production factory?
Chloroplast analogy is a bit of a stretch. Solar energy plants use light to convert carbon dioxide into glucose, which is then used to produce electricity. Chloroplast analogy would be to say that chloroplasts are like solar cells, and that they can use light to convert carbon dioxide into a different molecule, such as water or oxygen.	chloroplast	How is chloroplast analogous to solar energy plants?
Chloroplast is analogous to kitchen because it is a organelle in the plant cell that stores the genetic instructions for plant growth.	chloroplast	How is chloroplast analogous to kitchen?
Chloroplast analogy is a bit of a stretch. Solar panels use light to convert chemical energy into electrical energy, while chloroplasts use light to convert chemical energy into organic molecules.	chloroplast	How is chloroplast analogous to solar panels?
The cytoskeleton is analogous to the street. It is a network of proteins that help cells move and interact.	cytoskeleton	How is cytoskeleton analogous to street?
The cytoskeleton is analogous to metal framework in that it is a series of proteins that organize cells and allow them to move. The cytoskeleton is also responsible for the cell's ability to divide and to form new cells.	cytoskeleton	How is cytoskeleton analogous to metal framework?
Atp is an analogy to ready to eat food because it is a food that is ready to eat.	atp	How is atp analogous to ready to eat food?
Atp is analogous to a charged battery. They both have an electric potential difference and can store energy.	atp	How is atp analogous to charged battery?
Atp is analogous to money because it is a unit of account.	atp	How is atp analogous to money?
Nadph is an analogy to bus because both services provide transportation. Nadph is also similar in that it is a type of currency.	nadph	How is nadph analogous to bus?
The peroxysome is a type of organelle in the cells of the body that helps to produce energy. Street cleaners use peroxysomes to clean up messes.	peroxysome	How is peroxysome analogous to street cleaners?
Tochondria is analogous to power point because it is a presentation tool that can be used to communicate information.	mytochondria	How is mytochondria analogous to power point?
Electric forces are analogous to comb and pieces of paper because they are both physical objects that can be used to interact with other physical objects. Electric forces are strongest when they are in contact with other electric objects, and they are weakest when they are not in contact with other electric objects.	electric forces	How is electric forces analogous to comb and pieces of paper?
The hydrogen electron's orbital analogy to the atmosphere is that it is a gas with a high concentration of hydrogen atoms. Earth's atmosphere has a low concentration of hydrogen atoms because it is made up of oxygen and nitrogen.	hydrogen electron's orbital	How is hydrogen electron's orbital analogous to earthâ€™s atmosphere?
The first line of defense in the body analogy is the police station. The police station is a place where people can go to get help if they are in trouble. The first line of defense in the body analogy is to go to the police station.	first line of defense in the body	How is first line of defense in the body analogous to police station?
Macrophages are analogous to guards in that they are important in controlling the environment in which bacteria and other pathogens can grow.	macrophages	How is macrophages analogous to guards?
T-helper cells are analogous to constables in that they are responsible for monitoring and enforcing the rules of the cell.	t-helper cells	How is t-helper cells analogous to constables?
B-lymphocytes are analogous to police inspectors in that they are responsible for investigating crimes.	b-lymphocytes	How is b-lymphocytes analogous to police inspector?
Cytotoxic t-lymphocytes are analogous to action force in that they are capable of killing cells.	cytotoxic t-lymphocytes	How is cytotoxic t-lymphocytes analogous to action force?
The invasion of bacterias analogy is that bacterias are invading a country in order to create a new environment in which they can grow. Colonial invasion is when a country is invaded by a group of people who are looking to create a new society.	invasion of bacterias	How is invasion of bacterias analogous to colonial invasion in a country?
Action potentials are analogous to assembly line workers assembling products. The workers are constantly moving from one step to the next, and the product is constantly being assembled.	action potential	How is action potential analogous to assembly line?
The experiment of chromatography analogy to two cars taking a day trip is that the chromatography process separates the different types of molecules in a sample.	experiment of chromatography	How is experiment of chromatography analogous to two cars taking a day trip?
Main-sequence stars have a short life expectancy, about 100 million years. This is because they are born as small, low-mass stars and quickly grow in size and brightness. As they grow, they lose mass and their temperature decreases, leading to their death.	main-sequence lifetimes of stars	How is main-sequence lifetimes of stars analogous to how long a car can run?
Nucleus is analogous to the school principal. The school principal is in charge of the school and is responsible for the overall operation of the school.	nucleus	How is nucleus analogous to school principal?
Nucleus is analogous to a factory manager in that it is responsible for the overall production of a product.	nucleus	How is nucleus analogous to factory manager?
Nucleus is analogous to a restaurant manager. They are responsible for the overall running of the restaurant and are in charge of the staff. They are also in charge of the finances of the restaurant.	nucleus	How is nucleus analogous to restaurant manager?
Nucleus is analogous to brain in that it is a large, complex organ that helps to create and maintain the chemical balance in the body.	nucleus	How is nucleus analogous to brain?
Nucleus is analogous to library because it is a place where books are stored. Library is a place where people can find books.	nucleus	How is nucleus analogous to library?
Ribosomes are analogous to school vice-principal. They are responsible for the organization and function of proteins in the body.	ribosomes	How is ribosomes analogous to school vice-principal?
Ribosomes are analogous to hamburger cook because they are used to create proteins.	ribosomes	How is ribosomes analogous to hamburger cook?
Ribosomes are analogous to machines in that they are used to produce proteins.	ribosomes	How is ribosomes analogous to machines?
Golgi apparatus analogy is that the golgi apparatus is analogous to a teacher. The golgi apparatus is a structure in the brain that helps to store and process information. The golgi apparatus is also responsible for helping to produce new memories.	golgi apparatus	How is golgi apparatus analogous to teacher?
Golgi apparatus is analogous to container boxes in that it is a means of packaging cells and other cells-related material.	golgi apparatus	How is golgi apparatus analogous to container boxes?
 Lysosomes are analogous to school janitors in that they are responsible for cleaning up the inside of cells and removing debris.	lysosomes	How is lysosomes analogous to school janitor?
Nuclear envelope analogy:School main office is a large, open room with a desk in the center and a number of chairs around the perimeter. The nuclear envelope is similar in design, with a large, round, metal core that is surrounded by a large, round, plastic outer shell.	nuclear envelope	How is nuclear envelope analogous to school main office?
A vacuole is a small, round, orifice in a cell that allows gas to escape and is analogous to a cabinet.	vacuoles	How is vacuoles analogous to cabinets?
Cytoplasm is analogous to the school secretary in that it is responsible for the organization and management of the cell.	cytoplasm	How is cytoplasm analogous to school secretary?
Cytoplasm is analogous to restaurant floor because it is the space in between cells that contains the cells' genetic instructions.	cytoplasm	How is cytoplasm analogous to restaurant floor?
Cytoplasm is analogous to sandwich stuffing. sandwich stuffing is a type of food that is made up of two or more pieces of bread that are put together with a variety of ingredients.	cytoplasm	How is cytoplasm analogous to sandwich stuffing?
Chromosomes are analogous to school websites in that they are used to store and display information about the genetic makeup of a person.	chromosome	How is chromosome analogous to school website?
Citosol is analogous to staff because it is a type of energy storage molecule.	cytosol	How is cytosol analogous to staff?
Cell is analogous to a factory in that it produces products. Factory produces products by using resources to produce goods.	cell	How is cell analogous to factory?
A vesicle is analogous to a transportation facility. Vesicles are small, round, and filled with a liquid. They are used to move liquids around.	vesicles	How is vesicles analogous to transportation facility?
Cell wall analogy is that of a factory gate. The cell wall is analogous to the factory gate, which is the first line of defense against invaders. The cell wall is also analogous to the fence around a factory, which keeps the factory safe from unauthorized access.	cell wall	How is cell wall analogous to factory gate?
Cell wall analogy is that a cell wall is analogous to a security guard. A cell wall is a physical barrier that separates one cell from another. A security guard is responsible for ensuring that the cells in a prison are safe and that no one is able to escape. Cell wall analogy is also used to describe the role of a cell wall in the body. A cell wall is a physical barrier that separates the cells in the body.	cell wall	How is cell wall analogous to security guard?
A restaurant is a place where people can eat. Cells are similar to restaurants because they are places where people can grow and divide their cells.	cells	How is cells analogous to restaurant?
Cell membrane analogy is that a restaurant door is like a cell membrane. The cell membrane is made up of a lipid bilayer and a protein layer. The lipid bilayer is made up of a series of fatty acids and cholesterol. The protein layer is made up of proteins.	cell membrane	How is cell membrane analogous to restaurant doors?
Cell membranes are analogous to windows in that they are used to allow the passage of water and other molecules.	cell membrane	How is cell membrane analogous to windows?
Cell membranes are analogous to skin in that they are made of a material that helps protect the cells inside the membrane from outside factors. The cell membrane also has a protein coating that helps keep the cells inside the membrane in contact with one another.	cell membrane	How is cell membrane analogous to skin?
Golgi body is analogous to front counter in that it is a type of cell that helps in the assembly of proteins.	golgi body	How is golgi body analogous to front counter?
Capacitance is analogous to heat content in that it measures how much heat is stored in a material.	capacitance	How is capacitance analogous to heat content?
Electric current is analogous to water in that it is a flow of energy. Electric current is also analogous to water in that it can be used to power devices.	electric current	How is electric current analogous to water tank?
 Voltage is analogous to the staircase because it is a way of transferring energy from one place to another.	voltage	How is voltage analogous to climbing a staircase?
In football, players are divided into two groups, the linebackers and the safeties. The linebackers are responsible for stopping the ball from being played by the quarterback, while the safeties are responsible for stopping the ball from being caught by the receiver. This analogy can be used to describe the communication between players in a cell. Players are responsible for communicating with one another to ensure that they are following the same plan.	specialization and communication in a cell	How is specialization and communication in a cell analogous to football?
Kirchoff's voltage law is analogous to hiking. When hiking, you are hiking up a hill. The higher you go, the more voltage you will experience. The same is true with electricity. When you are using electricity, you are using more voltage than you would if you were just using natural gas.	kirchoff's voltage law	How is kirchoff's voltage law analogous to hiking?
A density wave is analogous to a traffic jam on a highway. The waves are created when people are trying to move through a congested area. The higher the density of people, the more waves will be created. The higher the density of traffic, the more waves will be created.	nature of a density wave	How is nature of a density wave analogous to traffic jam on a highway?
Enzymes are analogous to keyholes. Keyholes are openings in the surface of a rock or other object through which water or other fluid can flow. Enzymes are similar to keyholes in that they are openings in the surface of a molecule through which chemical reactions take place.	enzymes	How is enzymes analogous to key hole?
Computer memory is a type of electronic storage where data is stored in a form that can be accessed by a computer. Human memory is a type of electronic storage where information is stored in a form that can be accessed by humans.	human active memory system	How is human active memory system analogous to computer?
The analogy is that the reaction is like buying stamps at the post office. The customer is waiting in line to buy the stamps, and the reaction is the same. The stamps are used to determine the amount of product that will be produced.	rate-determining step of a reaction	How is rate-determining step of a reaction analogous to buying stamps at the post office, when there is a long line of customers?
A rate-determining step in a reaction is analogous to the slowest moving car in traffic. The car is trying to move as quickly as possible to get to the next stoplight, but it is constantly slowed down by the other cars. The same is true in a reaction, where the reactants are trying to move as quickly as possible to produce the desired product.	rate-determining step of a reaction	How is rate-determining step of a reaction analogous to slowest moving car in traffic?
Column chromatography is analogous to separating bees and wasps because it is a way to remove large molecules from a sample. Column chromatography is also a way to separate different types of molecules.	column chromatography	How is column chromatography analogous to separating bees and wasps?
Dynamic chemical equilibrium is analogous to two jugglers. The jugglers are juggling two balls. The balls are moving around in a constantly changing environment. The jugglers are able to keep track of the balls' positions and movements.	dynamic chemical equilibrium	How is dynamic chemical equilibrium analogous to two jugglers?
A vacuole is analogous to a storage bag in that it stores energy. The difference is that a vacuole is filled with gas and a storage bag is filled with air. When a molecule of gas is introduced into a vacuole, the gas is immediately compressed and the pressure inside the vacuole increases. This increase in pressure causes the gas to form a clump and the vacuum is released.	vacuole	How is vacuole analogous to storage bags?
 Transport vesicles are analogous to delivery truck. They are small, cylindrical objects that are used to deliver drugs or other substances.	transport vesicles	How is transport vesicles analogous to delivery truck?
 Proto-oncogenes are analogous to car accelerator pedals. They are responsible for the growth of cancer cells.	proto-oncogenes	How is proto-oncogenes analogous to car accelerator?
Oncogenes are analogous to car accelerator pedals stuck in down position. When the oncogenes are activated, they can cause cancer.	oncogenes	How is oncogenes analogous to car accelerator stuck in down position?
Tumor suppressor genes are analogous to car brakes in that they are used to control the growth of tumors. Car brakes are used to stop the car from going any further and are similar to the tumor suppressor genes in that they are used to control the growth of tumors.	tumor suppressor genes	How is tumor suppressor genes analogous to car brakes?
Brittle software is analogous to jenga. When two pieces of software are trying to touch each other, they can easily fall off the game board. This is why software is often designed to be modular, so that different parts can be added and removed as needed.	brittle software	How is brittle software analogous to jenga?
Rhinoceros is a big, strong, and aggressive animal. Resonant hybrid is a small, weak, and timid animal.	resonance hybrid	How is resonance hybrid analogous to rhinoceros?
The wave mechanical model analogy between firefly and a wave is that fireflies are light and can be seen in the dark, while waves are large and can be seen in the light.	wave mechanical model	How is wave mechanical model analogous to firefly in a dark room?
The electroencephalogram (EEG) is a record of the electrical activity of the brain. It can be used to track the progress of a game, and to measure the effects of different activities on the brain.	electroencephalogram	How is electroencephalogram analogous to listening to a game?
Dna replication is analogous to photocopier machine because it copies the genetic information in a DNA sample.	dna replication	How is dna replication analogous to photocopier machine?
Book printing is a process of printing books by printing the text on large sheets of paper. The large sheets are then cut into smaller pages that are about twice the size of a finished book. The smaller pages are then divided into small groups, folded in half, and sewn together. The folded and sewn pages are then cut down to their finished size and glued to the spine of the book's cover.	dna replication	How is dna replication analogous to book printing?
Rna transcription is analogous to language translation because it is a process of translating one form of information into another form.	rna transcription	How is rna transcription analogous to language translation?
Protein translation is analogous to language translation in that it is a process of translating one set of instructions into another set of instructions. However, protein translation is also a process of assembling the amino acids that make up a protein into a correct order.	protein translation	How is protein translation analogous to language translation?
Ecosystem analogy is often used to describe the relationship between cities and their environment. In general, an ecosystem is a group of living things that interact with one another to create a shared environment. The environment in which a city lives is often different from the environment in which it was created. For example, the environment in which a city was created is often more rural than the environment in which it is now. However, the ecosystem in which a city lives is often more complex than the ecosystem in which it was created. For example, the environment in which a city was created is often composed of many different types of plants and animals. However, the ecosystem in which a city lives is often composed of a few types of plants and animals.	ecosystem	How is ecosystem analogous to cities?
A neuron propagates an action potential down a neuron by the process of diffusion. The action potential travels from the cell's surface to the interior of the neuron in a straight line.	propagation of an action potential down a neuron	How is propagation of an action potential down a neuron analogous to falling dominoes?
The breathing mechanism of frogs is analogous to the blowing of the balloon. The frog's lungs are filled with air and they use their lungs to breathe. When the frog blows the air out of its lungs, it is called a "breath."	breathing mechanism of frogs	How is breathing mechanism of frogs analogous to blowing of the balloon?
Layer architecture analogy:Translators are used to translate between two languages. Layers are used to create a communication system.	layered architecture	How is layered architecture analogous to communication with translators?
Chocolate distribution is analogous to limiting reactant and excess reactant in that it is a way of controlling the amount of chocolate that is produced.	limiting reactant and excess reactant	How is limiting reactant and excess reactant analogous to chocolate distribution?
A eukaryotic cell is analogous to a working office. The cell's nucleus is where the genetic information for the cell is stored, and the cell's cytoplasm is where the cell's metabolic processes take place.	eukaryotic cell	How is eukaryotic cell analogous to working office?
A prokaryotic cell is analogous to a self-started business. Prokaryotic cells are able to produce their own energy, which they use to create proteins and other molecules. This energy allows prokaryotic cells to survive and grow.	prokaryotic cell	How is prokaryotic cell analogous to self started business?
Operating systems are analogous to college libraries in that they provide a way for users to access information. The kernel is the heart of an operating system, and it provides the basic functions that allow applications to run.	operating systems kernel	How is operating systems kernel analogous to college library?
 limiting reactant analogy: limiting reactant analogy:A cup of coffee granules are small and have a lot of reactants in them. A limiting reactant analogy would be to say that reactants in a reaction are like small coffee granules.	limiting reactant	How is limiting reactant analogous to a cup of coffee granules?
Limiting reactant analogy is that limiting reactant analogy is that limiting reactant analogy is analogous to an engine. An engine is a machine that uses reactants to create energy. The same is true with Reactant Limitation. Reactant limitation is a way of limiting reactants to a specific set of reactants.	limiting reactant	How is limiting reactant analogous to engine?
Zipper is a type of fastener that is used to close two pieces of clothing together. Helicase is a type of enzyme that is used to cut DNA.	helicase	How is helicase analogous to zipper zip?
Dna replication binding proteins are analogous to hands holding open two strips of magnet. The proteins are able to bind to complementary pieces of DNA and open the strip of magnet.	dna replication binding proteins	How is dna replication binding proteins analogous to hands holding open two strips of magnet?
Ligase is analogous to a sewing machine because it can sew pieces of fabric together.	ligase	How is ligase analogous to sewing machine?
Process control block is analogous to inode in that it stores information about the state of a file.	process control block	How is process control block analogous to inode?
Message encoding is analogous to speaking. A message is composed of a sequence of characters, called characters, that are combined to form a word. The characters in a message are combined to form a word by adding them together. The most common way to combine the characters in a message is to use a combination of letters, called a word order.	message encoding	How is message encoding analogous to speaking?
The analogy between drug interaction and lock and key is that when you try to open the door with your key, the lock is preventing you from doing so. The same is true with receptor sites. When you try to interact with a receptor site, the drug is preventing you from doing so.	interaction between drugs and receptor sites	How is interaction between drugs and receptor sites analogous to lock and key?
The analogy between drug interaction and foot fitting is that drug interaction is analogous to the process of foot fitting a shoe. The drug and receptor sites must be lined up correctly in order for the drug to bind and work.	interaction between drugs and receptor sites	How is interaction between drugs and receptor sites analogous to foot fitting in footprint?
Monitor is an analogy to human face because it is a three-dimensional object that can be seen by the naked eye.	monitor	How is monitor analogous to human face?
There is no one answer to this question as cpu and brain are different types of machines. However, some similarities between cpu and brain include the fact that they are both able to process and store information, and that they are both able to communicate with other machines.	cpu	How is cpu analogous to brain?
A motherboard is analogous to a skeleton in that it is a physical structure that helps hold the computer components in place. The motherboard is also responsible for providing electrical and data connections to the computer.	motherboard	How is motherboard analogous to skeleton?
There is no one answer to this question as ram is a unique brain structure that is not analogous to the pre-frontal lobe in any way.	ram	How is ram analogous to pre-frontal lobe?
A power supply unit is analogous to an energy source. It provides power to electronic devices to allow them to function.	power supply unit	How is power supply unit analogous to energy?
A keyboard is analogous to hands in that they are used to type. A keyboard has a number pad on the left side and a keypad on the right side. The number pad can be used to enter numbers, and the keypad can be used to enter letters.	keyboard	How is keyboard analogous to hands?
Mouse is an analogy to senses because it has a body and a set of sensors that allow it to track its surroundings.	mouse	How is mouse analogous to senses?
An audio card is analogous to an ear in that it is a device that allows you to listen to audio.	audio card	How is audio card analogous to ear?
A video card is analogous to an eye. It is a device that allows a computer to display images.	video card	How is video card analogous to eye?
The age calculation for trees and coral is similar. The difference is that coral is a living organism that produces eggs that will eventually hatch into coral larvae. Trees, on the other hand, are not living organisms and do not produce eggs. Instead, the tree's age is calculated by adding the number of years the tree has been alive to the number of years the tree has been growing.	tree's age calculation	How is tree's age calculation analogous to coral's age calculation?
Glycolysis is a process in the body that breaks down glucose into pyruvate and lactate. Roller coasters use a lot of energy to go up and down the track. This is the same process that is used by the body to break down glucose into pyruvate and lactate.	glycolysis	How is glycolysis analogous to roller coaster?
The analogy between anti-stokes scattering and ball striking a plate is that anti-stokes scattering is analogous to when a ball is striking a plate. Anti-stokes scattering is a type of scattering that occurs when an electron is scattered off of an atom or molecule. This type of scattering is often used to study the behavior of molecules and atoms.	anti-stokes scattering	How is anti-stokes scattering analogous to ball striking a plate?
Stokes scattering is analogous to ball striking a plate. The energy of the ball is scattered in all directions, with the most energy scattered in the direction of the impact. This is why stokes scattering is so important in physics, as it is the process that allows us to measure the energy of particles in detail.	stokes scattering	How is stokes scattering analogous to ball striking a plate?
Median lethal dose is a measure of the amount of a poison that will kill 50% of the population in a given amount of time. It is also analogous to balls and targets. The median lethal dose is the amount of a poison that will kill 50% of the population in a given amount of time, multiplied by the number of people in the population.	median lethal dose	How is median lethal dose analogous to balls and target?
The surface of a balloon is like the universe. The universe is like a big, round, white balloon. The balloon is filled with gas. The gas is like the universe. The balloon is big and round. The gas is like the universe. The balloon is made of paper. The paper is like the gas. The paper is like the universe.	universe	How is universe analogous to surface of a balloon?
The enzyme mechanism analogy is that enzymes are analogous to keys that can open and close locks.	enzyme mechanism	How is enzyme mechanism analogous to lock and key?
Anova is a statistic that helps to find the difference between two groups of data. It is similar to finding a signal in the noise.	anova	How is anova analogous to finding signal in the noise?
The hypothalamus is a small, inconspicuous part of the brain that controls body temperature. The thermostat is a device that regulates the temperature of a room or house.	thermostat	How is thermostat analogous to hypothalamus?
Chemical equilibrium is analogous to water level in a dam and lake. In a dam, the water level is controlled by the weight of the objects in the dam. In a lake, the water level is controlled by the weight of the objects in the lake.	chemical equilibrium	How is chemical equilibrium analogous to water level in dam and lake?
Just-in-time is a manufacturing process where products are made to the correct specifications in a timely manner. Just-in-time is also similar to water and rocks because they are all elements that can be used to make something else.	just-in-time	How is just-in-time analogous to water and rocks?
Adaptive immunity is similar to police headquerters. Police headquerters are individuals who are specially trained in identifying and apprehending criminals. Adaptive immunity is the same thing, except that it is used to identify and apprehend individuals who are Adaptive.	adaptive immunity	How is adaptive immunity analogous to police headquerters?
Ohm's law is analogous to cats, mice and cake because they all have an impedance (resistance) to current.	ohm's law	How is ohm's law analogous to cats, mice and cake?
Transcription is a process of copying text from one medium to another. The copying process is usually done by a person who is familiar with the language the text is written in.	transcription	How is transcription analogous to photocopying?
Rna polymerase is analogous to a Xerox machine in that it can photocopy DNA.	rna polymerase	How is rna polymerase analogous to xerox machine?
Ribosome analogy: Cook is analogous to a ribosome in that it is a protein-making machine. Ribosomes are responsible for translating mRNA into proteins.	ribosome	How is ribosome analogous to cook?
Activator protein is similar to bookmarks because it is a protein that helps to keep track of where a person has been in the past.	activator protein	How is activator protein analogous to bookmarks?
Electric circuits are analogous to airflows through tubes. The electric current in a tube is analogous to the air current flowing through a tube. The electric fields in a tube are analogous to the fields in the air.	electric circuit	How is electric circuit analogous to air flowing through a tube?
Electric circuits are analogous to ropes through metal rings because they are composed of metal wires that are connected together. The metal wires are connected to the battery, and the battery is connected to the electric current. The electric current is used to power the electric motor, and the electric motor is used to move the object in the circuit.	electric circuit	How is electric circuit analogous to rope through metal rings?
The hydrophobic effect is analogous to teenagers at a party. They are all trying to find their place in the world and figure out who they are.	hydrophobic effect	How is hydrophobic effect analogous to teenagers at a party?
Biological signal transduction is analogous to threat communication in animals. The difference is that animals have a much more limited repertoire of threat signals, and they can only send a limited number of them at a time.	biological signal transduction	How is biological signal transduction analogous to threat communication in animals?
