Nadh is similar to a car battery. The battery starts the car and provides power to make it run. Nadh does the same thing for the body by starting up energy production.	nadh	What analogy is used to explain nadh?
Nadh is to energy as blood is to the body.	nadh	What analogy is used to explain nadh?
Nadh is like a spark plug in a car. It starts the engine by igniting the fuel.	nadh	What analogy is used to explain nadh?
Nadh is often called the "life force" of the body. It's responsible for producing energy in cells and helping to regulate metabolism. This analogy might help you understand it better: Imagine your body as a car. The engine (your muscles) need fuel to run, just like your car needs gasoline. The gas tank stores the fuel, and the carburetor mixes it with air so that the engine can use it. In the same way, your cells need nadh to use oxygen to create energy.	nadh	What analogy is used to explain nadh?
Nadh is to energy as blood is to the body.	nadh	What analogy is used to explain nadh?
A protein is like a Lego set. It has many different pieces that can be put together in many different ways to create something new.	proteins	What analogy is used to explain proteins?
A protein is like a chainmail shirt. It has many small pieces that are connected to each other.	proteins	What analogy is used to explain proteins?
A protein may be thought of as a molecular machine with many parts that work together to perform a specific task.	proteins	What analogy is used to explain proteins?
The analogy used to explain proteins is that they are like the workers in a factory. Proteins work together to create products, just as the workers in a factory work together to create products.	proteins	What analogy is used to explain proteins?
A protein is like a Lego block. Just as you can build different things with Legos, proteins can be put together to form different structures that carry out various functions in the body.	proteins	What analogy is used to explain proteins?
A strand of DNA is like a twisted ladder. The rungs of the ladder are made up of pairs of chemicals called nucleotides.	dna	What analogy is used to explain dna?
A strand of dna is like a long, thin ladder. The rungs of the ladder are made up of pairs of molecules called nucleotides.	dna	What analogy is used to explain dna?
DNA is like a set of instructions for making a protein.	dna	What analogy is used to explain dna?
Dna is like a set of blueprints that tell the cell how to build proteins.	dna	What analogy is used to explain dna?
Dna is like a library book. It has all the information needed to create a living thing.	dna	What analogy is used to explain dna?
Glycogen is often compared to a battery. Just as a battery can store energy, glycogen stores energy in the body.	glycogen	What analogy is used to explain glycogen?
A glycogen molecule is like a train. A train has many cars that are connected to each other. The cars are the same as the glycogen molecules. The engine is like the glucose molecule.	glycogen	What analogy is used to explain glycogen?
A glycogen molecule is like a string of pearls, with glucose units strung on it.	glycogen	What analogy is used to explain glycogen?
A glycogen molecule is like a string of pearls. Each pearl is a glucose molecule.	glycogen	What analogy is used to explain glycogen?
Glycogen is a carbohydrate that is stored in the muscle and liver. It can be compared to gasoline in a car. The glycogen provides energy for the muscles just as the gasoline powers the engine of the car.	glycogen	What analogy is used to explain glycogen?
Endoplasmic reticulum is often compared to a factory. The organelle has several functions, including producing proteins and lipids. Just as a factory has assembly lines where products are created, the endoplasmic reticulum has areas where new proteins and lipids are synthesized.	endoplasmic reticulum	What analogy is used to explain endoplasmic reticulum?
Endoplasmic reticulum is compared to a factory with many machines. The machines are called "ribosomes" and they produce the proteins that are needed in the cell.	endoplasmic reticulum	What analogy is used to explain endoplasmic reticulum?
Endoplasmic reticulum is often compared to a highway. The mRNA travels down the "highway" to the ribosomes, where it is then translated into proteins.	endoplasmic reticulum	What analogy is used to explain endoplasmic reticulum?
Endoplasmic reticulum is like a railroad system inside the cell. The "tracks" are the tubes that run throughout the cell, and the "train cars" are the sac-like structures that hold proteins.	endoplasmic reticulum	What analogy is used to explain endoplasmic reticulum?
Endoplasmic reticulum is a system of membranes that form tubes and sheets inside cells. It's often compared to the interstate highway system, with different types of roads (arteries, veins, and capillaries) carrying traffic in all directions.	endoplasmic reticulum	What analogy is used to explain endoplasmic reticulum?
A golgi analogy is like a post office. The postal service receives mail from all over the country, sorts it by zip code, and delivers it to the right addresses. The golgi apparatus receives proteins from all over the cell, sorts them by their function, and delivers them to their correct destinations.	golgi	What analogy is used to explain golgi?
A golgi is like a postal worker. It takes the packages (proteins) from the factory (ribosomes) and sorts them into different mailboxes (cell parts).	golgi	What analogy is used to explain golgi?
Golgi is to the cell as a post office is to mail. Just as mail travels through the postal system, proteins and other materials travel through Golgi on their way to various destinations within and outside of the cell.	golgi	What analogy is used to explain golgi?
Golgi is often described as a “post office” for the cell. Just as letters are sent through the postal system to different addresses, proteins and other materials are sent from one part of the cell to another via Golgi.	golgi	What analogy is used to explain golgi?
A Golgi apparatus is like a postal service. It takes messages from one part of the cell and sends them to another part.	golgi	What analogy is used to explain golgi?
The plasma membrane analogy is used to explain the structure of the cell membrane. The cell membrane is said to be like a fence with openings that allow things in and out of the cell. The fence analogy represents the lipid bilayer while the openings represent the proteins embedded in the membrane.	plasma membrane	What analogy is used to explain plasma membrane?
The analogy of the plasma membrane to a brick wall is often used. The bricks are like the phospholipids in the membrane and the mortar is like the proteins in the membrane.	plasma membrane	What analogy is used to explain plasma membrane?
A plasma membrane can be thought of as a barrier that sits between the inside and outside of a cell. It is made up of two layers of lipids (fats) and proteins, which act like a gatekeeper, allowing only certain things to pass through.	plasma membrane	What analogy is used to explain plasma membrane?
A plasma membrane is similar to a brick wall. The bricks are the cells and the mortar is the plasma membrane.	plasma membrane	What analogy is used to explain plasma membrane?
A plasma membrane is like a net with very small holes in it. The small holes let some things pass through, while keeping other things out.	plasma membrane	What analogy is used to explain plasma membrane?
Lysosomes are likened to a digestive system within the cell. Just as the stomach and small intestine digest food, breaking it down into molecules that can be absorbed by the body, lysosomes digest cellular components, breaking them down into smaller molecules that can be used by the cell.	lysosome	What analogy is used to explain lysosome?
A lysosome is a sac-like organelle that contains digestive enzymes. The analogy used to explain lysosomes is that of a garbage can. Just as a garbage can collects trash, lysosomes collect waste products within the cell.	lysosome	What analogy is used to explain lysosome?
Lysosomes are like trash cans inside of cells. They digest old or damaged proteins and molecules.	lysosome	What analogy is used to explain lysosome?
A lysosome is like a garbage can inside a cell. It breaks down old or damaged cells parts, and recycles the materials.	lysosome	What analogy is used to explain lysosome?
The analogy used to explain lysosomes is that they are like the stomachs of cells. Just as the stomach breaks down food so that the body can use it, lysosomes break down larger molecules into smaller pieces that can be used by the cell.	lysosome	What analogy is used to explain lysosome?
A peroxisome is like a small factory in the cell. It takes in raw materials, manufactures something new, and then exports it out of the cell.	peroxisomes	What analogy is used to explain peroxisomes?
A peroxisome is like a small factory in the cell. It takes fatty acids and turns them into molecules that the cell can use for energy.	peroxisomes	What analogy is used to explain peroxisomes?
Peroxisomes are like little factories in the cell. They take raw materials, like fats and proteins, and turn them into useful products that the cell can use, like energy and molecules that help build new cells.	peroxisomes	What analogy is used to explain peroxisomes?
The analogy used to explain peroxisomes is that they are like the "garbage disposal" of the cell.	peroxisomes	What analogy is used to explain peroxisomes?
The analogy used to explain peroxisomes is that they are like the "garage" of the cell. This analogy is because peroxisomes are responsible for breaking down and getting rid of toxins and waste products in the cell.	peroxisomes	What analogy is used to explain peroxisomes?
Mitochondria are often compared to batteries, as they both store energy that powers the cell.	mitochondria	What analogy is used to explain mitochondria?
The analogy of mitochondria is that they are the batteries of the cell.	mitochondria	What analogy is used to explain mitochondria?
The analogy used to explain mitochondria is that they are the "power plants" of the cell.	mitochondria	What analogy is used to explain mitochondria?
Mitochondria are often called the "powerhouses" of the cell because they produce energy in the form of ATP. This analogy is helpful because it explains how mitochondria work and why they're important. Just as a powerplant produces electricity that powers our homes, mitochondria produce energy that powers the cell.	mitochondria	What analogy is used to explain mitochondria?
The analogy used to explain mitochondria is that they are like the batteries in a car.	mitochondria	What analogy is used to explain mitochondria?
A chloroplast is a small, green organelle found in the cytoplasm of plant cells. It is in the shape of a disk and has two membranes surrounding it. Chloroplasts are unique because they have the ability to change light into chemical energy that can be used by plants to create glucose from carbon dioxide and water. An analogy for a chloroplast would be something like a solar panel, which also converts sunlight into usable energy.	chloroplast	What analogy is used to explain chloroplast?
A chloroplast is like a small factory inside the cell. It makes food for the plant using light energy from the sun.	chloroplast	What analogy is used to explain chloroplast?
Chloroplasts are compared to solar panels in that they convert light energy into electrical energy.	chloroplast	What analogy is used to explain chloroplast?
A chloroplast is like a small city. It has streets (ribosomes), houses (mitochondria), and parks (plastids).	chloroplast	What analogy is used to explain chloroplast?
A chloroplast is similar to a battery. It has two compartments, one filled with positively charged particles called ions and the other filled with negatively charged particles called electrons. These particles are constantly moving back and forth between the compartments, creating an electrical current that powers the plant's cells.	chloroplast	What analogy is used to explain chloroplast?
The cytoskeleton is often thought of as the cellular scaffolding. Just as a building needs a sturdy frame to hold it up, cells need a cytoskeleton to maintain their shape and keep important organelles in place.	cytoskeleton	What analogy is used to explain cytoskeleton?
The cytoskeleton analogy is used to explain a skeleton inside of a cell. The skeleton is made up of the cytoskeleton, which are the cells that make up the skeleton. Just like our bones help us move and stay upright, the cytoskeleton helps control the movement and shape of cells.	cytoskeleton	What analogy is used to explain cytoskeleton?
A cytoskeleton analogy would be to think of the cell as a city. The nucleus is the downtown area and all of the organelles are like the different neighborhoods. The cytoskeleton is made up of all of the streets and highways that connect everything together.	cytoskeleton	What analogy is used to explain cytoskeleton?
The cytoskeleton analogy is typically used to explain the skeletal system in humans. Just as bones provide a framework for the body, cytoskeletal proteins provide a structural foundation for cells. Additionally, both systems are able to grow and change in response to environmental stimuli.	cytoskeleton	What analogy is used to explain cytoskeleton?
The cytoskeleton analogy is used to explain that the cytoskeleton is like a skeleton inside of the cell. Just as our bones hold our body together and allow us to move, the cytoskeleton holds the cell together and allows it to move.	cytoskeleton	What analogy is used to explain cytoskeleton?
atp is the currency of energy in the body	atp	What analogy is used to explain atp?
Atp is to a battery as food is to a car.	atp	What analogy is used to explain atp?
ATP is like a battery in that it stores energy.	atp	What analogy is used to explain atp?
Atp is like a battery in your car. It provides the power that makes the car run.	atp	What analogy is used to explain atp?
Storing energy in a battery is similar to storing energy in atp. Just as a battery can be used to power devices like lights or motors, atp can be used to power the chemical reactions that occur inside cells.	atp	What analogy is used to explain atp?
Nadph is like a battery that stores energy and releases it when needed to do its job.	nadph	What analogy is used to explain nadph?
Nadph is like a battery that stores energy and can be used to do work.	nadph	What analogy is used to explain nadph?
NADPH is like a "battery" that helps the plant turn sunlight into food.	nadph	What analogy is used to explain nadph?
A nadph molecule is like a battery that can store energy and release it when needed.	nadph	What analogy is used to explain nadph?
NADPH is a key component of the electron transport chain that helps convert energy from food into useful forms for our cells. It is often compared to currency, as it is necessary for cells to "spend" in order to carry out essential processes.	nadph	What analogy is used to explain nadph?
A peroxysome is similar to a soap bubble. It is made of a thin membrane surrounding a small amount of liquid. The liquid in the peroxysome contains chemicals that are important for the cell's function.	peroxysome	What analogy is used to explain peroxysome?
A peroxysome is like a small factory inside the cell that uses oxygen to produce energy.	peroxysome	What analogy is used to explain peroxysome?
The analogy used to explain peroxysome is that they are like the "smoke detectors of the cell." They are responsible for detecting and getting rid of any potentially harmful toxins or free radicals in the cell.	peroxysome	What analogy is used to explain peroxysome?
A peroxysome is a tiny organelle in the cell that helps to break down hydrogen peroxide. It is similar to a small factory inside the cell that produces special chemicals.	peroxysome	What analogy is used to explain peroxysome?
A peroxysome is a small organelle in the cytoplasm of cells that catalyzes the oxidation of hydrogen peroxide to water and oxygen. It is similar to, but smaller than, an enzyme.	peroxysome	What analogy is used to explain peroxysome?
The analogy of mytochondria to a train is that the mitochondria are the engine and the cell is the car.	mytochondria	What analogy is used to explain mytochondria?
An analogy to explain mytochondria is that they are like the batteries in a car. Just as the battery powers the car, mytochondria power the cell.	mytochondria	What analogy is used to explain mytochondria?
The analogy used to explain mytochondria is a motor. Mytochondria are the motors that help cells move and work.	mytochondria	What analogy is used to explain mytochondria?
The analogy that is used to explain mytochondria is the comparison of mytochondria to a computer. Mytochondria are responsible for the production of energy in cells, just as a computer is responsible for the processing of information.	mytochondria	What analogy is used to explain mytochondria?
Mytochondria are often compared to batteries. Just as a battery powers a device, mytochondria produce energy for the cell. Mytochondria also help cells recycle materials and remove waste products.	mytochondria	What analogy is used to explain mytochondria?
A good analogy to electric forces is the attraction between magnets. Like charges repel each other, while opposite charges attract each other.	electric forces	What analogy is used to explain electric forces?
Electric forces are described as being similar to the gravitational force between two masses. Just like gravity, electric forces decrease in strength as the distance between the objects increases.	electric forces	What analogy is used to explain electric forces?
The electric force between two objects is like the gravitational force between them, except that it is much weaker.	electric forces	What analogy is used to explain electric forces?
The analogy used to explain electric forces is that they are like two magnets with the same polarity repelling each other and two magnets with opposite polarity attracting each other.	electric forces	What analogy is used to explain electric forces?
Electric forces are like magnets. Magnets have two poles, a north pole and a south pole. Opposite poles attract each other while like poles repel each other. Electric charges also have two types, positive and negative. Like charges repel each other while opposite charges attract each other.	electric forces	What analogy is used to explain electric forces?
The analogy used to explain hydrogen electron's orbital is that of a planet orbiting the sun. Just as planets orbit around the sun, electrons orbit around the nucleus of an atom.	hydrogen electron's orbital	What analogy is used to explain hydrogen electron's orbital?
The analogy used to explain hydrogen electron's orbital is a planetary system. Just as planets orbit around the sun, electrons orbit the nucleus of an atom.	hydrogen electron's orbital	What analogy is used to explain hydrogen electron's orbital?
An analogy to explain hydrogen electron's orbital is that of a person on a swing. The person represents the electron and the swing represents the orbit. When the person pushes off from the ground, they are in an "orbit" around the swing set.	hydrogen electron's orbital	What analogy is used to explain hydrogen electron's orbital?
A hydrogen atom consists of one proton and one electron. The proton is located in the nucleus, and the electron occupies an orbital around the nucleus. An analogy that may be helpful to understand orbital is to imagine an amusement park ride called a carousel. A rider on a carousel sits in a seat that revolves around the center of the ride. In much the same way, an electron occupying an atomic orbital revolves around the nucleus of the atom.	hydrogen electron's orbital	What analogy is used to explain hydrogen electron's orbital?
The analogy used to explain hydrogen electron's orbital is that of a person on a ferris wheel. The person is sitting in a car at the top of the wheel and as the wheel turns they are carried around. In the same way, the electron is travelling around the nucleus.	hydrogen electron's orbital	What analogy is used to explain hydrogen electron's orbital?
The analogy used to explain the first line of defense in the body is a brick wall. The bricks are the cells and tissues in the body that make up the wall and the mortar is the fluid that surrounds and separates them.	first line of defense in the body	What analogy is used to explain first line of defense in the body?
The analogy of the body's first line of defense is that it is like a castle with a moat. The moat is the water around the castle that keeps people out. The walls are high and thick and have towers where people can watch for enemies. The gates are closed and locked at night.	first line of defense in the body	What analogy is used to explain first line of defense in the body?
A first line of defense in the body is like a fence around a property. It keeps unwanted things out and protects what is inside.	first line of defense in the body	What analogy is used to explain first line of defense in the body?
A first line of defense is like a fortress with walls and gates. The body's first line of defense includes the skin, mucous membranes, tears, and saliva. These barriers protect the body from harmful substances and microbes.	first line of defense in the body	What analogy is used to explain first line of defense in the body?
A first line of defense in the body is similar to a castle with walls. The walls are strong and keep out most things that try to get in. If something does make it past the wall, there are more defenses inside the castle waiting to stop it.	first line of defense in the body	What analogy is used to explain first line of defense in the body?
A macrophage is like a vacuum cleaner. It sucks up all the dirt and debris in its surroundings.	macrophages	What analogy is used to explain macrophages?
A macrophage is like a bouncer at a nightclub. It is always on the lookout for anything that may be harmful to the body and will try to get rid of it.	macrophages	What analogy is used to explain macrophages?
A macrophage is a scavenger cell that roams the body and eats up debris, such as dead cells, bacteria, or other particles. This analogy can be used to explain how macrophages work in the body: just as a scavenging animal cleans up after others, so do macrophages clean up any messes in the body.	macrophages	What analogy is used to explain macrophages?
Macrophages are often compared to the white blood cells in our bodies because they both fight infection. Macrophages, however, are much larger than white blood cells and can engulf and destroy pathogens and debris.	macrophages	What analogy is used to explain macrophages?
A macrophage is like a vacuum cleaner. It cleans up the mess and gets rid of any garbage or debris that is in its way.	macrophages	What analogy is used to explain macrophages?
T-helper cells are like the generals of an army. They give orders to other cells in order to fight off infection or disease.	t-helper cells	What analogy is used to explain t-helper cells?
A T-helper cell is like a quarterback on a football team. The quarterback doesn't play the game, but instead directs the players and tells them what to do.	t-helper cells	What analogy is used to explain t-helper cells?
T-helper cells are likened to the Geek Squad of the immune system. They are not frontline fighters, but they provide essential support for the immune response.	t-helper cells	What analogy is used to explain t-helper cells?
One analogy used to explain t-helper cells is that they are like the "brain" of the immune system. They help orchestrate and direct the other cells involved in fighting infection or disease.	t-helper cells	What analogy is used to explain t-helper cells?
A t-helper cell is like a quarterback on a football team. The quarterback's job is to direct the other players on the field and make sure they're all doing their jobs correctly. T-helper cells do the same thing for other immune system cells - they help coordinate their actions and make sure everything is working together properly.	t-helper cells	What analogy is used to explain t-helper cells?
The analogy of a library is often used to explain b-lymphocytes. B-cells are like the librarians who keep track of all the different books (antigens) in the library and know where everything is located. When someone needs a specific book, the librarian can help them find it quickly.	b-lymphocytes	What analogy is used to explain b-lymphocytes?
A B-lymphocyte is like a bouncer at a club. It stands guard and watches for anything that could harm the body. If it finds something, it will sound the alarm to other cells in the immune system to help fight off the threat.	b-lymphocytes	What analogy is used to explain b-lymphocytes?
A machine that manufactures cars analogy is used to explain b-lymphocytes. Just as a factory needs workers, machines, and raw materials to produce cars, the body's lymphatic system needs B cells, T cells, and antigens to make antibodies.	b-lymphocytes	What analogy is used to explain b-lymphocytes?
B-lymphocytes are compared to workers in a factory. Just as the workers produce the products that the factory sells, b-lymphocytes produce antibodies that fight off infections.	b-lymphocytes	What analogy is used to explain b-lymphocytes?
A B-lymphocyte is like a bouncer at a club. It stands guard and helps protect the body from infection.	b-lymphocytes	What analogy is used to explain b-lymphocytes?
The analogy used to explain cytotoxic t-lymphocytes is that they are like "Pacman" cells. They travel around the body eating up cancer cells and other invaders.	cytotoxic t-lymphocytes	What analogy is used to explain cytotoxic t-lymphocytes?
One analogy used to explain cytotoxic T-lymphocytes is that they are like "guided missiles" that seek out and destroy cells that have been infected or are cancerous.	cytotoxic t-lymphocytes	What analogy is used to explain cytotoxic t-lymphocytes?
The analogy of cytotoxic T-lymphocytes is that they are like snipers. They can identify specific cells that need to be destroyed and then shoot them down quickly and effectively.	cytotoxic t-lymphocytes	What analogy is used to explain cytotoxic t-lymphocytes?
The analogy used to explain cytotoxic t-lymphocytes is that they are like snipers. They are able to specifically identify and kill cancer cells or cells that have been infected with a virus.	cytotoxic t-lymphocytes	What analogy is used to explain cytotoxic t-lymphocytes?
Cells that have been infected with a virus and are producing viral proteins will be recognized as "non-self" by cytotoxic T cells. The cytotoxic T cells will then release toxins to kill the infected cells.	cytotoxic t-lymphocytes	What analogy is used to explain cytotoxic t-lymphocytes?
The analogy of an infection is often used to describe how bacteria can invade the body. This analogy typically involves describing the body as a "castle" and the bacteria as "invaders." The immune system is then described as the "defenders" of the castle, and their job is to protect against these invaders.	invasion of bacterias	What analogy is used to explain invasion of bacterias?
One analogy to describe the invasion of bacteria is that of an army invading a country. Just as an army would use strategies like infiltration and encirclement to penetrate a country's defenses, bacteria can use similar methods (like swimming through mucus) to get past the body's natural barriers and cause infection.	invasion of bacterias	What analogy is used to explain invasion of bacterias?
The analogy used to explain the invasion of bacteria is that of an army invading a country. The bacteria are like the soldiers and they invade the cells in the body like they are taking over new territory.	invasion of bacterias	What analogy is used to explain invasion of bacterias?
A common analogy used to explain how bacteria can invade the body is to imagine them as tiny, swimming creatures that are able to break through a microscopic crack in the skin. Just as a foreign object like a splinter can get under the skin and cause an infection, bacteria can do the same.	invasion of bacterias	What analogy is used to explain invasion of bacterias?
A common analogy used to explain invasion of bacteria is that of a group of people pushing their way into a small room. The more people who enter, the harder it becomes for those already in the room to move around. In the same way, as more and more bacteria invade an area, they take up space and make it difficult for other cells to survive.	invasion of bacterias	What analogy is used to explain invasion of bacterias?
The analogy of a dam is used to explain action potential. The water (action potential) behind the dam is like the voltage or electrical charge in a neuron. When there is enough pressure, the water will flow over the top of the dam (spike of an action potential).	action potential	What analogy is used to explain action potential?
A metaphor for the action potential is a speeding freight train. Just as the train needs a lot of energy to get up to speed, so does the neuron need a lot of energy to generate an action potential.	action potential	What analogy is used to explain action potential?
Action potential is like a garden hose. When the water pressure inside the hose becomes greater than the atmospheric pressure outside, liquid starts to flow from high-pressure to low-pressure areas until equilibrium is reached. This happens because of the law of conservation of energy which states that energy cannot be created or destroyed, only changed from one form to another. In this analogy, water represents electrical current and atmospheric pressure represents voltage.	action potential	What analogy is used to explain action potential?
The action potential is often compared to a water wave. Just as a water wave travels outward from its source, the action potential travels down the neuron's axon.	action potential	What analogy is used to explain action potential?
A neuron is like a telegraph wire. When the message (action potential) comes down the line, it travels faster than anything else.	action potential	What analogy is used to explain action potential?
The analogy used to explain the experiment of chromatography is that it is like a "sticky note." The different colors on the sticky note are like the different compounds in the sample, and they stick to the paper differently depending on their size and chemical makeup. By separating the colors, you can get a better idea of what's in the sample.	experiment of chromatography	What analogy is used to explain experiment of chromatography?
A good analogy for chromatography is that it is like a “magnetic fishing net.” The different compounds in the mixture are like fish, and the solvent is like water. As the charged particles (the molecules of compound) move through the solvent, they are attracted to either the positively or negatively charged end of the paper strip (or column). Larger molecules will be slower to travel through than smaller ones. This means that by looking at how far up on the strip each type of molecule has traveled, we can get an idea of how much of each type was in the original mixture.	experiment of chromatography	What analogy is used to explain experiment of chromatography?
Chromatography is often described as the process of "separating the colors" in a rainbow. This analogy can be used to explain how chromatography works: just as sunlight is separated into its different colors by a prism, so too are the different components of a mixture separated by chromatography.	experiment of chromatography	What analogy is used to explain experiment of chromatography?
The analogy used to explain the experiment of chromatography is that it is like a "sorting hat" from the Harry Potter series. Just as the sorting hat can sort students into their respective houses at Hogwarts, chromatography can separate different compounds in a mixture based on their chemical properties.	experiment of chromatography	What analogy is used to explain experiment of chromatography?
A popular analogy used to explain chromatography is that of a grocery store. The different products (colors) on the shelves are like the compounds being separated on the chromatograph plate. The customer (solvent) is like the mobile phase, and it moves down the aisle (the column of the chromatograph). As it moves, it picks up different items depending on how soluble they are in that particular solvent.	experiment of chromatography	What analogy is used to explain experiment of chromatography?
A star's lifespan can be thought of as being similar to that of a human. The main sequence is the time period during which a star is using hydrogen fusion to generate energy, just like in humans' teenage years and early adulthood. Once the hydrogen runs out, the star either becomes a red giant or a white dwarf.	main-sequence lifetimes of stars	What analogy is used to explain main-sequence lifetimes of stars?
A star's life can be thought of as a marathon. The main sequence is the race itself, and once a star completes this race it has exhausted its nuclear fuel.	main-sequence lifetimes of stars	What analogy is used to explain main-sequence lifetimes of stars?
Stars are born out of gas and dust in a process called star formation. The mass of the star determines how long it will live on the main sequence. A large, massive star will use up its hydrogen fuel quickly and die in a supernova explosion. A small, low-mass star will live for billions of years on the main sequence.	main-sequence lifetimes of stars	What analogy is used to explain main-sequence lifetimes of stars?
A star's lifespan can be compared to that of a human. Just as humans are born, live for a while, and then die, stars are born, live for a while burning hydrogen in their cores, and then die when they run out of fuel.	main-sequence lifetimes of stars	What analogy is used to explain main-sequence lifetimes of stars?
A star's lifetime can be thought of as its "main sequence life." Just like a human's main sequence life is the time during which they are most productive and vigorous, so too is a star's main sequence life. A star spends most of its lifetime on the main sequence, slowly burning through its fuel and growing more luminous. When it runs out of fuel, it leaves the main sequence and enters into one of the later stages of its life.	main-sequence lifetimes of stars	What analogy is used to explain main-sequence lifetimes of stars?
Nucleus is often compared to a city. Just as a city has many different parts that make it up, nucleus has many different parts that work together to make the cell function.	nucleus	What analogy is used to explain nucleus?
The nucleus is like a city. It is the center of activity and has many important functions.	nucleus	What analogy is used to explain nucleus?
Nucleus is like the brain of a cell. It controls what happens in the cell and directs how it grows and functions.	nucleus	What analogy is used to explain nucleus?
Nucleus is to atom as _____ is to cell.Organelles are to cells as atoms are to molecules.	nucleus	What analogy is used to explain nucleus?
Nucleus is like the brain of a cell. It controls what the cell does and how it behaves.	nucleus	What analogy is used to explain nucleus?
Ribosomes are like a factory. They make the proteins that our cells need to work properly.	ribosomes	What analogy is used to explain ribosomes?
Ribosomes are compared to a construction site. The blueprints (mRNA) tell the builders what to build and the workers (ribosomes) use the tools (amino acids) to do the building.	ribosomes	What analogy is used to explain ribosomes?
Ribosomes can be thought of as the tiny machines that build the proteins inside our cells. Just as a factory has machines that help it build cars, ribosomes have machines that help them build proteins.	ribosomes	What analogy is used to explain ribosomes?
Ribosomes are compared to a team of construction workers.	ribosomes	What analogy is used to explain ribosomes?
A ribosome is like a construction site. The blueprints for the building are on one side of the site and the workers are building it on the other side. The workers use the blueprints to build the parts of the building that they need.	ribosomes	What analogy is used to explain ribosomes?
The Golgi apparatus is likened to a postal service. The cells produce large packages of proteins (the mail), which are sent to the Golgi apparatus where they are sorted and packaged for delivery to other parts of the cell (or, eventually, outside the cell).	golgi apparatus	What analogy is used to explain golgi apparatus?
The golgi apparatus is like a post office. It receives messages from other parts of the cell, sorts them and sends them on their way.	golgi apparatus	What analogy is used to explain golgi apparatus?
The Golgi apparatus is often compared to a post office. The smooth endoplasmic reticulum is like the mail room, where letters (protein) are prepared for delivery. The Golgi apparatus is like the postal worker who sorts and distributes the mail.	golgi apparatus	What analogy is used to explain golgi apparatus?
One analogy used to explain the golgi apparatus is as a post office. The golgi apparatus receives packages (molecules) from different parts of the cell, processes them, and sends them off to their final destinations.	golgi apparatus	What analogy is used to explain golgi apparatus?
A Golgi apparatus is like a post office. It takes letters (packages of proteins) from one part of the cell and sends them to another part of the cell.	golgi apparatus	What analogy is used to explain golgi apparatus?
Lysosomes are often compared to garbage disposals. Just as a garbage disposal grinds up food scraps and washes them down the drain, lysosomes digest cellular debris and recycle their components.	lysosomes	What analogy is used to explain lysosomes?
Lysosomes are often compared to garbage cans inside of cells. They are small sacs that process and break down cellular debris, such as old proteins and cell membranes. This function is important because it helps keep the cell clean and functioning properly.	lysosomes	What analogy is used to explain lysosomes?
A lysosome is like a garbage disposal in a kitchen sink. It breaks down food and other wastes so they can be eliminated from the body.	lysosomes	What analogy is used to explain lysosomes?
Lysosomes are like the stomach of a cell. The stomach breaks down food and nutrients so that the body can absorb them. Lysosomes break down cellular waste products so that the cell can reuse their components.	lysosomes	What analogy is used to explain lysosomes?
Lysosomes are often compared to garbage cans inside of cells. Just as a city might have several different garbage collectors who each have their own truck and route, lysosomes have different enzymes that allow them to break down a variety of substances.	lysosomes	What analogy is used to explain lysosomes?
The nuclear envelope is similar to the skin of an onion. It surrounds the nucleus and has many layers.	nuclear envelope	What analogy is used to explain nuclear envelope?
Nuclear envelope is compared to a balloon. The nuclear membrane is the thin film that covers the nucleus, and the nuclear material is like the air in the balloon.	nuclear envelope	What analogy is used to explain nuclear envelope?
The nuclear envelope can be compared to the skin of an onion. It surrounds and protects the nucleus, just as the skin surrounds and protects the edible center of an onion.	nuclear envelope	What analogy is used to explain nuclear envelope?
Nuclear envelope is compared to the skin of an onion.	nuclear envelope	What analogy is used to explain nuclear envelope?
The nuclear envelope analogy is used to explain the process of mitosis. The nucleus is likened to an orange, and the membrane surrounding the nucleus is likened to the skin of the orange. Just as you would have to cut through the skin of an orange in order to get to its juicy center, you would have to cut through the nuclear envelope in order to get to the DNA inside the nucleus.	nuclear envelope	What analogy is used to explain nuclear envelope?
The analogy of a spider's web is often used to explain vacuoles. Just as the spider has a web that it uses to catch prey, the plant has vacuoles that it uses to store food and water.	vacuoles	What analogy is used to explain vacuoles?
The analogy used to explain vacuoles is that they are like a balloon. The balloon is filled with water and when it pops, the water spills out. In the same way, when a plant cell dies, the vacuole explodes and all of its contents spill out.	vacuoles	What analogy is used to explain vacuoles?
The analogy used to explain vacuoles is that they are like bubbles in a glass of soda. They are small and round, and they float around in the liquid.	vacuoles	What analogy is used to explain vacuoles?
A vacuole is like a container of water that you put in the freezer. The water will turn into ice and take up less space than the liquid water did. The same thing happens with vacuoles. They can fill up with fluid or air, and when they do, they get smaller.	vacuoles	What analogy is used to explain vacuoles?
A vacuole is like a balloon. It can inflate and deflate depending on what it needs to do.	vacuoles	What analogy is used to explain vacuoles?
Cytoplasm is often compared to a city. It is filled with different types of people (organelles) who all have a specific job to do in order to keep the cell alive and functioning.	cytoplasm	What analogy is used to explain cytoplasm?
The analogy of cytoplasm is to think of it as a soup. The cells are the vegetables and the proteins, lipids, and other molecules are the spices.	cytoplasm	What analogy is used to explain cytoplasm?
Cytoplasm is like a soup. It contains the nutrients that the cell needs to survive and it also helps to protect the DNA inside of the nucleus.	cytoplasm	What analogy is used to explain cytoplasm?
A cytoplasm analogy can be made to explain its function. Cytoplasm can be thought of as the "blood" of a cell, circulating and providing nutrients and oxygen to the organelles within it. It also helps remove waste products from these organelles. Just as blood circulates throughout our bodies, carrying essential nutrients and oxygen to our organs, cytoplasm circulates throughout cells, supplying their organelles with what they need to survive.	cytoplasm	What analogy is used to explain cytoplasm?
Water is to a fish as cytoplasm is to a cell. Just as water fills up the fish and surrounds its organs, cytoplasm fills up the cell and surrounds its organelles.	cytoplasm	What analogy is used to explain cytoplasm?
A chromosome is like a necklace with beads on it.	chromosome	What analogy is used to explain chromosome?
The analogy of chromosomes to beads on a string is often used.	chromosome	What analogy is used to explain chromosome?
One analogy used to explain chromosomes is that they are like beads on a string. Chromosomes are composed of DNA, which is made up of long chains of molecules called nucleotides. The string analogy is helpful because it shows how the sequence of nucleotides in DNA forms a code that provides instructions for building proteins.	chromosome	What analogy is used to explain chromosome?
A chromosome is like a long piece of yarn. It has many parts that are all tangled together.	chromosome	What analogy is used to explain chromosome?
Chromosomes are compared to beads on a string.	chromosome	What analogy is used to explain chromosome?
The analogy of cytosol to a crowded city street is often used. The protein and nucleic acid molecules are represented as people, and the water in the cytosol is represented as the streets.	cytosol	What analogy is used to explain cytosol?
The cytosol is like a city. It has many different parts that work together to keep the city running. The cells in our body are like the citizens of the city. The nucleus is like the mayor, and it oversees everything that goes on in the cytosol.	cytosol	What analogy is used to explain cytosol?
Cytosol is often compared to a city. The nucleus is the downtown area, while the mitochondria are like factories in the suburbs. Ribosomes are similar to small businesses, and cytoskeleton proteins act as the roads and sidewalks.	cytosol	What analogy is used to explain cytosol?
The cytosol is like the soup inside a can of Campbell's Soup. It surrounds and supports the cells' organelles, just as the soup surrounds and supports the vegetables and noodles in the can. Just as you might expect, there are many different types of molecules in cytosol, including water, proteins, lipids, carbohydrates, and ions.	cytosol	What analogy is used to explain cytosol?
Cytosol is like the ocean. It surrounds all of the cells in our body and provides a home for important organelles, such as the nucleus. Just as fish live in the ocean and are surrounded by salt water, cells live in cytosol and are surrounded by a saline solution.	cytosol	What analogy is used to explain cytosol?
A cell is like a factory. It takes in raw materials, manufactures products, and then exports them.	cell	What analogy is used to explain cell?
A cell is like a small city. It has workers, including managers, police officers, and construction workers; it has a communication system; it reproduces; and it grows.	cell	What analogy is used to explain cell?
A cell is like a small city. It has workers, managers, and a mayor.	cell	What analogy is used to explain cell?
The cell is like a tiny city. It has factories that produce proteins, it has a transportation system to move things around, and it has workers who carry out the instructions of the genes.	cell	What analogy is used to explain cell?
A cell is like a small factory. It takes in raw materials, manufactures products, and exports them.	cell	What analogy is used to explain cell?
A vesicle is like a balloon. The balloon is filled with air and when you blow into the balloon, the air inside pushes against the rubber of the balloon causing it to expand. Vesicles are filled with something called cytosol and when the cytosol pushes against the membrane of the vesicle, it causes it to expand.	vesicles	What analogy is used to explain vesicles?
An analogy used to explain vesicles is that they are like boats. Just as boats can hold a lot of cargo, vesicles can hold a lot of molecules.	vesicles	What analogy is used to explain vesicles?
A vesicle is like a small balloon. The balloon has a thin layer of rubber around it and when air is blown into the balloon, the rubber stretches. The same thing happens with a vesicle. It has a thin layer of protein around it and when something pushes on the vesicle, the protein stretches.	vesicles	What analogy is used to explain vesicles?
The analogy of vesicles is that they are like a balloon. They are filled with liquid and when they burst, the liquid spills out.	vesicles	What analogy is used to explain vesicles?
The analogy used to explain vesicles is that they are like bubbles. Just as a bubble forms when air or gas is trapped in water, vesicles form when something is trapped inside the cell membrane.	vesicles	What analogy is used to explain vesicles?
A cell wall is like the skin of a balloon. It keeps the balloon from bursting and protects the air inside.	cell wall	What analogy is used to explain cell wall?
The cell wall analogy is used to explain that just like the walls of a house protect the inhabitants, the cell wall protects the contents of a cell.	cell wall	What analogy is used to explain cell wall?
A cell wall can be thought of as the skeleton of a plant. It provides support for the plant and helps to keep it in shape.	cell wall	What analogy is used to explain cell wall?
A cell wall is like the skin of a balloon. It's strong and keeps the air trapped inside.	cell wall	What analogy is used to explain cell wall?
A cell wall is a lot like the outside of a house. It protects the inside of the house and keeps out things that could harm it.	cell wall	What analogy is used to explain cell wall?
Cells are like machines. Machines have parts that work together to make the machine work. Cells have parts that work together to make the cell work.	cells	What analogy is used to explain cells?
One analogy to explain cells is that they are like tiny cities. Just as in a city, there are many different types of people who live and work together to keep things running smoothly. In a cell, there are different types of proteins that work together to keep the cell functioning.	cells	What analogy is used to explain cells?
A cell is like a small city. It has workers, buildings, a power source, and a way to get rid of waste.	cells	What analogy is used to explain cells?
A cell is like a small city. It has workers, managers, and buildings that all work together to keep the cell running.	cells	What analogy is used to explain cells?
The analogy of cells is that they are like the organs in our body. Just as our organs work together to keep us alive and functioning, our cells work together to keep us alive and functioning.	cells	What analogy is used to explain cells?
A cell membrane analogy is that it is like a brick wall. The bricks are the cells and the mortar is the cell membrane.	cell membrane	What analogy is used to explain cell membrane?
A cell membrane analogy would be to think of the cell membrane as a fortress with walls that protect the cells inside. The wall is made up of a material that allows some things to pass through it while keeping other things out.	cell membrane	What analogy is used to explain cell membrane?
The cell membrane analogy is often used to explain the concept of a cell membrane. The analogy states that the cell membrane is like a wall with tiny holes in it. The wall blocks everything from getting in or out, except for things that are small enough to fit through the tiny holes.	cell membrane	What analogy is used to explain cell membrane?
The cell membrane analogy is used to explain that the cell membrane is like a fence. The fence separates the property (inside of the fence) from everything else outside of the fence.	cell membrane	What analogy is used to explain cell membrane?
The analogy of a cell membrane is that it is like a soap bubble. It is a thin layer that surrounds the cells and protects them.	cell membrane	What analogy is used to explain cell membrane?
The Golgi body is like a shipping and receiving department for the cell. It processes proteins that are made in the endoplasmic reticulum, modifying them and sending them to other parts of the cell.	golgi body	What analogy is used to explain golgi body?
The Golgi body is like a post office. It takes the mail (the proteins) from the different departments in the cell and sends it to the right places.	golgi body	What analogy is used to explain golgi body?
A Golgi body is like a post office. It receives packages (the vesicles from the endoplasmic reticulum), processes them, and then sends them out to other parts of the cell or to other cells.	golgi body	What analogy is used to explain golgi body?
The Golgi body is like a post office in the body. It takes packages (membranes) from one part of the cell and delivers them to other parts of the cell.	golgi body	What analogy is used to explain golgi body?
A golgi body is like a post office. It processes and packages information (in the form of proteins) that is sent to it from other parts of the cell.	golgi body	What analogy is used to explain golgi body?
A capacitor is like a water balloon. The more water you put into the balloon, the higher it will float. A capacitor is like two plates of metal with a little bit of water in between them. If you add more electricity to the system, the voltage (height) of the water goes up.	capacitance	What analogy is used to explain capacitance?
A capacitance is like a bucket of water. The more water in the bucket, the more it can hold. The same is true for capacitors; the greater the capacitance, the more charge it can store.	capacitance	What analogy is used to explain capacitance?
A capacitor is like a water tower. The higher the water level in the tower, the more pressure there is on the pipes below. Similarly, the higher the voltage between the two plates of a capacitor, the more force there is pushing electrons through the circuit.	capacitance	What analogy is used to explain capacitance?
A capacitor is like a water tank. The more water in the tank, the higher the pressure.	capacitance	What analogy is used to explain capacitance?
A capacitor is like a water tank. The bigger the tank, the more water it can hold. A capacitor stores energy in an electric field just like a tank holds water.	capacitance	What analogy is used to explain capacitance?
Electric current is like water flowing through a hose. The more water that flows, the bigger the current.	electric current	What analogy is used to explain electric current?
Water analogy is used to explain electric current. Just as the flow of water can power machines, the flow of electricity powers our devices.	electric current	What analogy is used to explain electric current?
electric current is often compared to the flow of water in a river. Just as the current of a river can push boats along, so electric current can power devices plugged into an outlet.	electric current	What analogy is used to explain electric current?
electric current is like a river of electrons flowing through a wire	electric current	What analogy is used to explain electric current?
Electric current is like water flowing through a hose.	electric current	What analogy is used to explain electric current?
The analogy of voltage is that it is like water pressure. Just as you need a certain amount of water pressure to get the water flowing through a pipe, you need a certain amount of voltage (pressure) to get electricity flowing through a wire.	voltage	What analogy is used to explain voltage?
A common analogy for voltage is that of water pressure. Just as water pressure can be thought of as the potential energy per unit volume of water, voltage can be thought of as the potential energy per unit charge of electricity.	voltage	What analogy is used to explain voltage?
A voltage is similar to water pressure. Just as the higher water pressure in a hose can move more water than the lower pressure, a high voltage can push more electricity through a wire than a low voltage.	voltage	What analogy is used to explain voltage?
A voltage is like water pressure. Just as the higher water pressure in a hose can push water further and do more work than the lower pressure at the end of the hose, a higher voltage can push electrons farther and do more work than a lower voltage.	voltage	What analogy is used to explain voltage?
A voltage is like a water pressure. Just as the higher water pressure in a hose can push more water through it, a higher voltage can push more electricity through a wire.	voltage	What analogy is used to explain voltage?
A cell is like a small city. The nucleus is the mayor, and the proteins are the workers. The ribosomes are the factories, and the genes are the blueprints.	specialization and communication in a cell	What analogy is used to explain specialization and communication in a cell?
A cell is like a small city. The nucleus is the mayor and the proteins are the workers. The DNA is the blueprint for the city.	specialization and communication in a cell	What analogy is used to explain specialization and communication in a cell?
A cell is like a small city. It has specialized parts that do different things, just as in a real city there are specialized parts such as police officers, firefighters, and construction workers. In order for the cell to work properly, all of these specialized parts need to be able to communicate with each other.	specialization and communication in a cell	What analogy is used to explain specialization and communication in a cell?
The analogy of a cell is like that of an office. The workers in the office are specialized in their work, such as one person who processes the mail and another who answers the phone. There must be communication between these workers for them to do their jobs effectively.	specialization and communication in a cell	What analogy is used to explain specialization and communication in a cell?
A cell analogy that can be used to explain specialization and communication is a city. A city has many different parts, such as the police department, the fire department, hospitals, schools, etc. Each of these parts has a specific role in keeping the city running smoothly. The police department specializes in law enforcement while the fire department specializes in fighting fires. Hospitals specialize in providing medical care and schools specialize in teaching students. Each part of the city communicates with the other parts to make sure that they are all working together towards the common goal of keeping the city running smoothly.	specialization and communication in a cell	What analogy is used to explain specialization and communication in a cell?
Kirchhoff's Voltage Law (KVL) states that the sum of all voltages in a loop is zero. This can be analogy to water flowing through a hose. If there are multiple outlets along the hose, the water pressure at each outlet is the same. No matter how much water flows out of one outlet, it is equal to the amount of water flowing into that outlet from other outlets.	kirchoff's voltage law	What analogy is used to explain kirchoff's voltage law?
A resistor in a circuit is like a pipe. The voltage drop across the resistor is analogous to water pressure, and the current through the resistor is analogous to the flow of water.	kirchoff's voltage law	What analogy is used to explain kirchoff's voltage law?
A good analogy for Kirchhoff's voltage law is to imagine that you are at a parade. You are standing on one side of the street, and all of the floats are passing by on the other side of the street. As each float goes by, it throws candy onto the sidewalk in front of you. The candy represents electrical charge, and as more and more candy accumulates on the sidewalk, it starts to create a voltage difference between where you are standing (the negative side) and where the candy is piling up (the positive side). Kirchhoff's voltage law states that this voltage difference will always be zero or less; in other words, no matter how much charge builds up on one side of a circuit, it will never cause avoltage difference big enough to spark an arc across the gap.	kirchoff's voltage law	What analogy is used to explain kirchoff's voltage law?
A resistor is like a pipe with water flowing through it. The voltage drop across the resistor is like the water pressure at different points in the pipe.	kirchoff's voltage law	What analogy is used to explain kirchoff's voltage law?
A loop of wire is like a circle of people. If you walk around the outside of the group, clockwise, you'll end up where you started. But if you walk around the inside of the group (counterclockwise), you'll end up in a different place. In electrical terms, this is called Kirchhoff's Voltage Law.	kirchoff's voltage law	What analogy is used to explain kirchoff's voltage law?
The analogy used to explain the nature of a density wave is that of people in a stadium. Just as the people are all moving around, but not really going anywhere, the atoms in a solid are also moving around, but they are not really going anywhere either.	nature of a density wave	What analogy is used to explain nature of a density wave?
A density wave is like a group of people who are all trying to move through a doorway at the same time. The people in the back of the group keep moving forward, but the people in the front keep getting stuck.	nature of a density wave	What analogy is used to explain nature of a density wave?
A density wave is like a traffic jam on a highway.	nature of a density wave	What analogy is used to explain nature of a density wave?
A density wave is often compared to a traffic jam. Just as cars slow down and bunch up when there is congestion on the highway, atoms in a material can clump together when they are squeezed together by an external force.	nature of a density wave	What analogy is used to explain nature of a density wave?
A density wave is a bit like traffic on a highway. The cars (molecules) are still moving, but they are all moving in the same direction at the same speed.	nature of a density wave	What analogy is used to explain nature of a density wave?
An analogy used to explain enzymes is that they are like tiny machines. Enzymes help chemical reactions happen in the body by speeding them up.	enzymes	What analogy is used to explain enzymes?
Enzymes are like keys that unlock the door to chemical reactions.	enzymes	What analogy is used to explain enzymes?
One analogy used to explain enzymes is that they are like tiny machines. Enzymes help things happen in the body by speeding up chemical reactions.	enzymes	What analogy is used to explain enzymes?
An analogy that can be used to explain enzymes is a lock and key. The enzyme is the lock and the substrate is the key.	enzymes	What analogy is used to explain enzymes?
An enzyme is like a key that unlocks the door to the chemical reaction.	enzymes	What analogy is used to explain enzymes?
The analogy of an active memory system is that it is like a computer. Just as a computer has random access memory (RAM) and a hard drive, the human brain has short-term memory and long-term memory. The RAM stores the information that is being used at the moment, while the hard drive stores information that is not currently being used but can be recalled later.	human active memory system	What analogy is used to explain human active memory system?
A human active memory system is said to be like a computer's random access memory (RAM). Just as a computer can access any byte of information in its RAM almost instantly, humans can remember any detail from their past experiences very quickly. However, just as a computer's RAM loses data when it is not powered on, humans forget memories over time if they are not accessed regularly.	human active memory system	What analogy is used to explain human active memory system?
The human active memory system is often compared to a computer's random access memory (RAM). Just as computers use RAM to store data that is currently being used, humans use their active memory to store information that they are currently using.	human active memory system	What analogy is used to explain human active memory system?
The active memory system is like a computer. It has a processor, which is the part that does the work, and it has storage, which is where information is kept. The processor can access information from the storage whenever it needs to, but if the information isn't in the storage, then the processor can't get to it.	human active memory system	What analogy is used to explain human active memory system?
The human active memory system is like a computer. It has a limited amount of storage, and it can only hold so many things in its memory at one time. The way it works is that when something new comes into the memory, something else needs to be removed to make room for it.	human active memory system	What analogy is used to explain human active memory system?
The analogy of a race is often used to explain the rate-determining step of a reaction. The fastest runner in the race determines the overall speed of the race, just as the rate-determining step determines the speed of a reaction.	rate-determining step of a reaction	What analogy is used to explain rate-determining step of a reaction?
The rate-determining step of a reaction is analogous to the slowest person in a race. Just as that person determines the overall speed of the race, the rate-determining step determines the speed of the entire reaction.	rate-determining step of a reaction	What analogy is used to explain rate-determining step of a reaction?
A reaction can be compared to a staircase. The rate-determining step is the slowest step in the reaction, just as going up a staircase one step at a time is slower than running up the stairs.	rate-determining step of a reaction	What analogy is used to explain rate-determining step of a reaction?
The analogy of a race can be used to explain the rate-determining step of a reaction. The fastest runner in the race is the one who determines the overall time it takes for the race to finish. In a chemical reaction, the rate-determining step is the slowest step in the reaction and it determines how quickly the reaction will occur.	rate-determining step of a reaction	What analogy is used to explain rate-determining step of a reaction?
The analogy of a race is used to explain the rate-determining step of a reaction. The race analogy is used to illustrate that there can be many participants in a race, but only one individual who is running the race at any given time. This analogy can be applied to reactions by illustrating that there are many steps involved in a reaction, but only one step that determines the overall rate of the reaction.	rate-determining step of a reaction	What analogy is used to explain rate-determining step of a reaction?
Column chromatography is often compared to a staircase. The solvent travels up the column (the stairs) and carries the molecules with it. As the molecules get heavier, they will slowly fall out of the solvent and into the bottom of the column (the landing).	column chromatography	What analogy is used to explain column chromatography?
Column chromatography is often compared to a house of cards. The small, thin cards are the individual pieces of paper that make up the column. The thicker card at the bottom is like the solid support that holds up the rest of the column. The liquid that is being separated (the solvent) flows through the spaces in between the cards, just as it flows through the spaces in between all of the tiny particles in a solution.	column chromatography	What analogy is used to explain column chromatography?
Column chromatography is often described as a "sifting" process. The stationary phase (the column) acts as a filter, trapping the molecules that are smaller than the size of the hole at the bottom of the column. Larger molecules can flow through the filter, while smaller molecules are trapped.	column chromatography	What analogy is used to explain column chromatography?
Column chromatography is often compared to a staircase. The mobile phase (liquid) travels up the column (like people ascending a staircase), while the stationary phase (solid) remains at the bottom of the column (like the steps on a staircase).	column chromatography	What analogy is used to explain column chromatography?
Column chromatography is like a clothes dryer. The solvent travels up the column, just like hot air rises in a clothes dryer. The compounds travel down the column, just like clothes tumble down in a dryer.	column chromatography	What analogy is used to explain column chromatography?
A balance scale analogy can be used to explain dynamic chemical equilibrium. The left side of the analogy is analogous to the reactants, while the right side of the analogy is analogous to the products. Just as a balance scale needs to be in equilibrium for it to remain still, so too does a chemical reaction need to reach equilibrium for the reaction rate to become zero.	dynamic chemical equilibrium	What analogy is used to explain dynamic chemical equilibrium?
The analogy of a teeter-totter is used to explain dynamic chemical equilibrium. When one side of the teeter-totter (the reactants) goes up, the other side (the products) goes down. And when one side goes down, the other side goes up. So they are always in balance.	dynamic chemical equilibrium	What analogy is used to explain dynamic chemical equilibrium?
The analogy used to explain dynamic chemical equilibrium is two people pushing a car. If one person pushes the car from the back and the other person pushes it from the front, eventually both people will stop pushing and the car will stay in place. Similarly, when two molecules are reacting to form a new molecule, if one of the molecules is depleted then eventually both molecules will stop reacting and equilibrium will be established.	dynamic chemical equilibrium	What analogy is used to explain dynamic chemical equilibrium?
One analogy used to explain dynamic chemical equilibrium is the example of a tennis ball. If someone gently tosses a tennis ball up in the air, it will gradually come to a stop and hover in place. This is because the upward force of gravity is balanced by the downward forces of air resistance and friction. In a similar way, at dynamic chemical equilibrium, the rates of forward and reverse reactions are equal, so there is no net change in concentration over time.	dynamic chemical equilibrium	What analogy is used to explain dynamic chemical equilibrium?
Dynamic chemical equilibrium is analogous to a spinning top. The top is constantly in motion, but it eventually comes to rest because of the equal opposing forces of gravity and friction. In the same way, molecules in a system are constantly moving around, but reach equilibrium because of the opposing forces of entropy and energy	dynamic chemical equilibrium	What analogy is used to explain dynamic chemical equilibrium?
The analogy used to explain vacuole is that the vacuoles are like small balloons.	vacuole	What analogy is used to explain vacuole?
A vacuole is like a balloon.	vacuole	What analogy is used to explain vacuole?
A vacuole is like a balloon.	vacuole	What analogy is used to explain vacuole?
A vacuum cleaner is a good analogy for a vacuole. They are both devices that use suction to clean surfaces.	vacuole	What analogy is used to explain vacuole?
A vacuum cleaner is used to suck up dirt and debris from the floor. A vacuole is a structure inside a plant cell that performs a similar function, sucking in water and other nutrients.	vacuole	What analogy is used to explain vacuole?
The analogy of transport vesicles is that it is like a postal service. The transport vesicle delivers the cargo (the letter) to the correct address (the cell).	transport vesicles	What analogy is used to explain transport vesicles?
A transport vesicle is like a bus. The vesicles carry cargo (proteins) to different parts of the cell.	transport vesicles	What analogy is used to explain transport vesicles?
A transport vesicle is a small bubble-like sac that helps ferry proteins and other materials around the cell. This analogy might help you picture it: Imagine your city has an efficient public transportation system with buses, subways, and taxis. The cells of your body also have an efficient public transportation system, which we call transport vesicles. Just as buses, subways, and taxis can all take you to different places in your city, so too can different types of transport vesicles carry proteins and other materials to different parts of the cell.	transport vesicles	What analogy is used to explain transport vesicles?
A transport vesicle is like a bus. It can carry many people (molecules) from one place to another.	transport vesicles	What analogy is used to explain transport vesicles?
A possible analogy to help explain transport vesicles is to imagine them as tiny mail trucks. The cells produce these little trucks and they drive around the cell delivering packages (proteins) to different parts of the cell.	transport vesicles	What analogy is used to explain transport vesicles?
A proto-oncogene is a normal gene that, when mutated, can become an oncogene. A good analogy to explain how this works is to think of cancer as a house fire. The firefighters are the proto-oncogenes and the arsonist is the oncogene. The firefighters are trying to put out the fire (prevent cancer), but the arsonist keeps setting more fires (causing cancer).	proto-oncogenes	What analogy is used to explain proto-oncogenes?
Proto-oncogenes are like the spark plugs in a car. They create the energy that is needed for the cell to function.	proto-oncogenes	What analogy is used to explain proto-oncogenes?
A proto-oncogene is a normal gene that can turn into an oncogene. A good analogy to explain this would be to compare them to computer viruses. Computer viruses are originally created as benign programs, but they can be reprogrammed to do harm. Proto-oncogenes are like the original computer virus. They are initially harmless, but they can mutate and become harmful cancer-causing genes.	proto-oncogenes	What analogy is used to explain proto-oncogenes?
An analogy used to explain proto-oncogenes is that they are like the "foot soldiers" of cancer. Just as foot soldiers can be turned into destructive warriors with the help of a good commander, so too can proto-oncogenes be transformed into tumor-causing oncogenes with the assistance of certain proteins called transcription factors.	proto-oncogenes	What analogy is used to explain proto-oncogenes?
A proto-oncogene can be thought of as a "normal" gene that, under certain circumstances, can become an oncogene.	proto-oncogenes	What analogy is used to explain proto-oncogenes?
Oncogenes are like a car's accelerator. They can make cells grow and divide too quickly, which can lead to cancer.	oncogenes	What analogy is used to explain oncogenes?
Oncogenes are like the accelerator on a car. They can cause cells to grow and divide too quickly, which may lead to cancer.	oncogenes	What analogy is used to explain oncogenes?
One analogy used to explain oncogenes is that they are like "starter motors" in cars. Just as a starter motor helps get the car engine going, oncogenes help start the process of cancer growth.	oncogenes	What analogy is used to explain oncogenes?
Oncogenes are like the "gas pedal" of a car. They help to speed up cell growth and division, which can lead to cancer if they become mutated.	oncogenes	What analogy is used to explain oncogenes?
The analogy of oncogenes is that they are like the ignition switch to a car. They can turn on and promote cancer growth, or be turned off and stop cancer growth.	oncogenes	What analogy is used to explain oncogenes?
One analogy used to explain tumor suppressor genes is that they are like brakes on a car. Tumor suppressor genes help to keep cells from growing and dividing too quickly or in an uncontrolled way, which can lead to cancer.	tumor suppressor genes	What analogy is used to explain tumor suppressor genes?
A tumor suppressor gene is like a policeman in the city. The policeman's job is to keep order and protect the citizens. If there are too many criminals in the city, the policeman can't do his job effectively. Similarly, if there are too many tumors (criminals) in the body, the tumor suppressor genes can't do their job effectively.	tumor suppressor genes	What analogy is used to explain tumor suppressor genes?
A tumor suppressor gene analogy is used to explain how these genes work. The analogy compares the function of a tumor suppressor gene to that of a brake on a car. Just as brakes help keep a car under control, tumor suppressor genes help keep cells from becoming cancerous.	tumor suppressor genes	What analogy is used to explain tumor suppressor genes?
Tumor suppressor genes are like the brakes on a car. They help to keep cells from growing and dividing too quickly or in an uncontrolled way.	tumor suppressor genes	What analogy is used to explain tumor suppressor genes?
The analogy of tumor suppressor genes is that they are like the brakes on a car. They help to keep the cells in check and stop them from growing out of control.	tumor suppressor genes	What analogy is used to explain tumor suppressor genes?
Brittle software is like a glass vase. It looks fine from the outside, but it's weak and will easily break when you try to use it.	brittle software	What analogy is used to explain brittle software?
Brittle software is often described as being like a "glass house." Just as a strong gust of wind can easily shatter a glass house, so too can a small glitch or problem with brittle software easily cause it to fail.	brittle software	What analogy is used to explain brittle software?
A good analogy for brittle software is an egg. Eggs are fragile and if they are dropped, they will break. The same is true for brittle software – it can easily break if it is not handled correctly.	brittle software	What analogy is used to explain brittle software?
Brittle software is like a pane of glass. It may be beautiful to look at, but it's delicate and can easily break.	brittle software	What analogy is used to explain brittle software?
A software system is like an egg. It is strong and resilient as long as it is not mishandled, but can easily crack or shatter if it is subjected to too much stress.	brittle software	What analogy is used to explain brittle software?
A piano string is vibrating in its fundamental frequency. One end of the string is attached to a tuning fork that is also vibrating at its fundamental frequency. The other end of the string is free to move. When the two frequencies coincide, they will create a beat frequency.	resonance hybrid	What analogy is used to explain resonance hybrid?
An analogy that is often used to explain resonance hybrid is a Venn diagram. In a Venn diagram, there are three circles. The first circle is for all the electrons in an atom. The second circle is for the s-electrons, and the third circle is for the p-electrons. When there is more than one electron in an orbital, the different types of orbitals overlap. This means that some of the electrons in each type of orbital overlap with each other. The overlapping creates new orbitals, and these new orbitals are called resonance hybrids.	resonance hybrid	What analogy is used to explain resonance hybrid?
The analogy of resonance hybrid is used to compare the different waveforms that make up a particular sound. The waves are like kids on a playground, each playing their own individual game. But when they come together and play as one, the playground becomes louder and more exciting. This is similar to how resonance hybrid works; by combining different waveforms, you create a new and improved waveform that is louder and more resonant.	resonance hybrid	What analogy is used to explain resonance hybrid?
An analogy to explain resonance hybrid is two people shaking a rope. Each person shakes the same side of the rope and causes it to move up and down. If you shake one end of the rope, the opposite end will also move up and down because of the motion that was created by the other person. The same thing happens with resonance hybrids. When bonding electrons are moved around in different ways, they create waves of movement that travel through all parts of the molecule.	resonance hybrid	What analogy is used to explain resonance hybrid?
An analogy used to explain resonance hybrid is that of a group of people standing on a see-saw. The people at one end are the nuclei and the people at the other end are the electrons. When there is an equal number of people on each side, the see-saw is balanced and it doesn't move. But when more people get on one side, the see-saw tilts in that direction. In much the same way, when there are more electrons on one side of a molecule than nuclei (due to electron donation or acceptance), the molecule will be pushed in that direction.	resonance hybrid	What analogy is used to explain resonance hybrid?
The analogy used to explain the wave mechanical model is that of a group of people walking across a bridge. The people are the waves and the bridge is the medium.	wave mechanical model	What analogy is used to explain wave mechanical model?
A wave mechanical model is similar to a slinky.	wave mechanical model	What analogy is used to explain wave mechanical model?
The analogy used to explain the wave mechanical model is a vibrating string. When you pluck a guitar string, it starts vibrating at a certain frequency. The vibration creates waves that travel down the string and spread out in all directions. The same thing happens with a quantum system - when you excite it, it starts oscillating and creates waves that spread out through the system.	wave mechanical model	What analogy is used to explain wave mechanical model?
Waves can be described as a disturbance that travels through a medium, such as water or air. This disturbance can be in the form of an up-and-down motion, known as compression and rarefaction, or it can be in the form of a side-to-side motion, known as shear.	wave mechanical model	What analogy is used to explain wave mechanical model?
The analogy used to explain the wave mechanical model is that of a string being plucked on one end. The vibration will travel down the string and cause the other end to vibrate as well.	wave mechanical model	What analogy is used to explain wave mechanical model?
An analogy for an electroencephalogram is a group of people in a room, each with their own conversations. If you were to put your head in the middle of the room, you would be able to hear all of the conversations at once. This is similar to how an EEG works- by measuring electrical activity from different parts of the brain, it can detect which areas are active at any given time.	electroencephalogram	What analogy is used to explain electroencephalogram?
EEG is used to measure brain waves and can be compared to the way that a doctor would use an EKG machine to measure someone's heart rate.	electroencephalogram	What analogy is used to explain electroencephalogram?
A good analogy for an EEG is to think of the brain as a large computer. The electrical signals generated by the billions of neurons in our brains are akin to the electronic signals that flow through computer chips. Just like computers, different activities produce different patterns of electrical activity in our brains. When we are awake and active, our brains generate lots of fast, organized signals. When we are asleep or relaxed, our brains produce slower, more diffuse signals.	electroencephalogram	What analogy is used to explain electroencephalogram?
An analogy to explain an electroencephalogram (EEG) would be that of a group of people at a party. Each person is talking and the noise level is high. If you were to go up to one person and ask them what they are saying, they would likely tell you. However, if you were to go up to a group of people and ask them what they are saying, it would be difficult for you to hear any individual conversation. This is because the noise level is too high. The EEG works in a similar way. When someone has epilepsy, their brain waves are like the group of people at the party where it is difficult to hear any individual conversation.	electroencephalogram	What analogy is used to explain electroencephalogram?
EEG is used to measure the electrical activity of the brain. It can be thought of as similar to the way that a heart monitor measures the heart's electrical activity.	electroencephalogram	What analogy is used to explain electroencephalogram?
The analogy of DNA replication is that it is similar to a printer. The printer takes an electronic file and prints out multiple copies of the document on paper. In the same way, DNA replicates by taking an electronic file (the genetic information) and printing out multiple copies of itself onto new strands of DNA.	dna replication	What analogy is used to explain dna replication?
A water tank is filled with 100 gallons of water on Monday. On Tuesday, 25 gallons of water are removed from the tank and replaced with new water. Wednesday, 50 more gallons of fresh water are added to the tank. By Friday, how many gallons of water will be in the tank?The answer would be 125 gallons. This analogy can be used to explain how dna replication works because each day represents a cycle in which dna is replicated. The "old" DNA is depleted (removed) and then replaced with "new" DNA.	dna replication	What analogy is used to explain dna replication?
Dna replication is like a photocopy machine. The original document is placed on the glass, and the copy machine makes a duplicate of it.	dna replication	What analogy is used to explain dna replication?
A good analogy to explain DNA replication is that of a printer. Imagine that you have an image on paper that you want to copy. To make the copy, you would need a printer, some ink, and some paper. The first step would be to place the original image face down on the platen of the printer. Next, you would put a piece of blank paper over top of the original and feed it into the printer. Inside the printer, there is a cylindrical drum onto which the text or images are transferred by means of heat and pressure from an electrically charged ribbon. The toner (a powder similar in consistency to ink) on the ribbon adheres to the heated areas of image on the underlying sheet of paper, producing an exact duplicate of the original. Finally, once all copies have been made, you remove them from underneath theirblank sheets like individual pages from a book	dna replication	What analogy is used to explain dna replication?
A river can be used to explain dna replication. The two banks of the river represent the original dna molecule, and the water in between represents the new dna molecules that are created as a result of replication.	dna replication	What analogy is used to explain dna replication?
Rna transcription is similar to a photocopier. The rna transcript is a copy of the gene that was used to make it.	rna transcription	What analogy is used to explain rna transcription?
Rna transcription is similar to a photocopy machine. The original document is the dna and the copy of the document is the rna.	rna transcription	What analogy is used to explain rna transcription?
Rna transcription is similar to a movie projector. The genetic information in dna is like the filmstrip, and rna is like the projected image on the screen.	rna transcription	What analogy is used to explain rna transcription?
The analogy used to explain RNA transcription is that of a typist. The DNA is the original text and the RNA transcript is the typed copy.	rna transcription	What analogy is used to explain rna transcription?
A common analogy used to explain RNA transcription is that of a person speaking into a microphone. Just as the sound of the person's voice is captured by the microphone and turned into an electrical signal, genetic information in DNA is captured by RNA polymerases and turned into an RNA molecule.	rna transcription	What analogy is used to explain rna transcription?
The analogy of protein translation is similar to that of a machine. The genetic code is like the blueprint, and mRNA is like the construction worker who reads the blueprint and builds the machine. tRNA acts as the parts are delivered to the construction site, and proteins are like the finished product.	protein translation	What analogy is used to explain protein translation?
A comparison can be made between the protein synthesis process and a machine that manufactures cars. The ribosomes are like the assembly line, mRNA is like the blueprints, tRNAs are like the workers who put together the car parts, and proteins are like the finished cars.	protein translation	What analogy is used to explain protein translation?
A protein is like a sentence. The genetic code is the alphabet, and the sequence of codons are the words. The order of amino acids in a protein corresponds to the order of letters in a word.	protein translation	What analogy is used to explain protein translation?
A protein is like a sentence. The codons are the words, and the mRNA is like a paragraph. The ribosomes are like the readers of the paragraph, and they "read" three nucleotides at a time to create a new protein molecule.	protein translation	What analogy is used to explain protein translation?
A protein is like a sentence. The sequence of codons in the gene (the DNA alphabet) is like the text of a book. During translation, each three-letter codon is read by the ribosome and an amino acid is added to the growing chain, one letter at a time.	protein translation	What analogy is used to explain protein translation?
A community of different species all interacting with one another to create a balanced and self-sustaining environment is often described as an ecosystem.	ecosystem	What analogy is used to explain ecosystem?
The analogy of an ecosystem is often compared to that of a human body. Just as the human body has different parts that work together for the whole, an ecosystem has different parts that work together for the whole. The heart is responsible for pumping blood throughout the body, just as the sun is responsible for providing energy to all living things in an ecosystem. The lungs are responsible for bringing oxygen into the body and removing carbon dioxide, just as plants are responsible for taking in carbon dioxide and releasing oxygen into the atmosphere.	ecosystem	What analogy is used to explain ecosystem?
An analogy to explain ecosystem is a group of people who are working together on a project. Each person has their own task, and they all work together to complete the project. The ecosystem is made up of different parts that all work together to keep everything running smoothly.	ecosystem	What analogy is used to explain ecosystem?
The analogy of an ecosystem is often compared to that of a human body. Just as the human body has different organs (heart, lungs, brain) that work together to keep the person alive and functioning, so too does an ecosystem have different parts (plants, animals, bacteria) that work together to keep the environment alive and functioning.	ecosystem	What analogy is used to explain ecosystem?
The analogy of an ecosystem is that it is like a human body. The different parts of the ecosystem (such as the sun, plants, and animals) all work together to create an environment in which everything can survive. Just like humans need food, water, air, and sunlight to live, ecosystems also need these things to thrive.	ecosystem	What analogy is used to explain ecosystem?
A neuron is like a garden hose. When you turn on the water at the faucet, it takes a little time for the water to reach the end of the hose. But once it starts flowing, the water spreads out quickly. The same thing happens with an action potential. It starts at one end of the neuron and quickly spreads down its length.	propagation of an action potential down a neuron	What analogy is used to explain propagation of an action potential down a neuron?
An action potential is like a wave that travels down a neuron.	propagation of an action potential down a neuron	What analogy is used to explain propagation of an action potential down a neuron?
Action potentials are said to "propagate down a neuron" similar to the way waves propagate down a length of string. An action potential will start at one point on the neuron and travel down its length until it reaches the end.	propagation of an action potential down a neuron	What analogy is used to explain propagation of an action potential down a neuron?
A neuron is like a telephone line with an electrical current running down it. When you pick up the phone and press the button, that sends an electrical current down the line. If someone else is on the other end of the line, they will hear the sound of your voice. Similarly, when someone touches something that stimulates a nerve in their hand, that sends an electrical current down the neuron to their brain.	propagation of an action potential down a neuron	What analogy is used to explain propagation of an action potential down a neuron?
An action potential is like a wave traveling down a rope.	propagation of an action potential down a neuron	What analogy is used to explain propagation of an action potential down a neuron?
A frog's breathing mechanism is similar to that of a human. The frog inhales air through its nose and mouth, and the lungs extract oxygen from the air. The carbon dioxide-rich blood is then pumped back to all parts of the body through tubes called veins.	breathing mechanism of frogs	What analogy is used to explain breathing mechanism of frogs?
A frog's breathing mechanism is similar to that of a human. The frog inhales air through its nose, and the oxygen in the air diffuses into the blood vessels in the lungs. The frog then exhales carbon dioxide from its lungs.	breathing mechanism of frogs	What analogy is used to explain breathing mechanism of frogs?
The analogy used to explain the breathing mechanism of frogs is that it is similar to a straw. Just as when you suck on a straw, the frog's lungs fill with air when its mouth and nose are submerged under water.	breathing mechanism of frogs	What analogy is used to explain breathing mechanism of frogs?
A frog's breathing mechanism is similar to that of a human. Air enters the body through the nose or mouth and travels down the throat into the lungs. From there, it moves into the blood vessels and is distributed throughout the body.	breathing mechanism of frogs	What analogy is used to explain breathing mechanism of frogs?
The analogy used to explain the breathing mechanism of frogs is that it is similar to a bellows. The frog's chest and stomach muscles alternately contract and relax, pushing air in and out of their lungs.	breathing mechanism of frogs	What analogy is used to explain breathing mechanism of frogs?
A cake is a great analogy for layered architecture. Imagine the layers of a cake as different parts of an application. The bottom layer is the foundation, followed by one or more layers of cake (middle and upper), with frosting on top. Just like you can’t eat the cake without first cutting through the frosting, you can’t use an application without first accessing its underlying foundation.	layered architecture	What analogy is used to explain layered architecture?
A cake is a good analogy for layered architecture. The cake has different layers (e.g., crust, cake, frosting), and each layer has a specific function (e.g., hold the cake together, provide flavor and texture, add sweetness). Just as with a cake, a software system has different layers that serve specific functions.	layered architecture	What analogy is used to explain layered architecture?
A model of the Earth's interior is used to explain layered architecture. The earth has a core, mantle, and crust. The core is made up of metal and is very hot. The mantle is made of rock and is hotter than the crust. The crust is made of rock and ice and is cold.	layered architecture	What analogy is used to explain layered architecture?
A common analogy used to explain layered architecture is that of an onion. Each layer in the onion can be peeled away, revealing another layer beneath it. In a similar way, each layer in a layered architecture can be independently accessed and modified.	layered architecture	What analogy is used to explain layered architecture?
A common analogy used to explain layered architecture is that of a cake. Just as each layer of a cake has a specific role (such as the base, filling, and topping), each layer in a software system also has a specific role. The foundation layer provides basic functionality required by all other layers, the middleware layer provides functionality needed by multiple other layers, and the presentation layer provides the interface that users see and interact with.	layered architecture	What analogy is used to explain layered architecture?
In an analogy, a classroom is like a chemical reaction. The desks are the reactants and the students are the products. If there are too many desks for the number of students, then some students will have to stand. This is analogous to a situation where there is more limiting reactant than desired product. In this case, not all of the desired product can be formed because there isn't enough room (reactant).	limiting reactant and excess reactant	What analogy is used to explain limiting reactant and excess reactant?
An analogy is used to explain limiting reactant and excess reactant. A container of paint can be divided into three parts. The first part is filled with blue paint, the second part is filled with white paint, and the third part is empty. If you want to make green paint by mixing blue and white paint together, you need to use the blue paint from the first part and the white paint from the second part. You cannot use any of the blue or white paint from the third part because it is all gone.	limiting reactant and excess reactant	What analogy is used to explain limiting reactant and excess reactant?
If you are baking a cake, the flour is the limiting reactant. This means that no matter how much sugar and eggs you add, the cake will not get any bigger because there is only so much flour in the batter. The sugar and eggs are excess reactants.	limiting reactant and excess reactant	What analogy is used to explain limiting reactant and excess reactant?
An analogy used to explain limiting reactant and excess reactant is that of a buffet. If there are more people at the buffet than there are chairs, some people will have to stand. In this analogy, the people represent molecules of a gas and the chairs represent sites on which the molecules can react. The number of available chairs represents the amount of a particular reactant molecule present in the reaction mixture. If all of the potential reaction sites are filled with molecules of one particular reactant, no other molecules can participate in the reaction. This is known as a limiting reactant because it limits how much product can be formed.	limiting reactant and excess reactant	What analogy is used to explain limiting reactant and excess reactant?
A good analogy to understand limiting reactant and excess reactant is that of a party with a limited amount of food. If the party has, for example, 10 hamburgers and 20 guests, then each guest can only have one hamburger. If the guests start eating two burgers each, then there will not be enough hamburgers for everyone by the end of the party. In this analogy, the Hamburgers are like Reactants and the Guests are like Excess Reactants.	limiting reactant and excess reactant	What analogy is used to explain limiting reactant and excess reactant?
A eukaryotic cell is like a city. The nucleus is the mayor, controlling all the other parts of the cell. The mitochondria are like the factories, making energy for the cell to use. The cytoskeleton is like the roads and bridges, connecting everything else in the cell. And finally, ribosomes are like the workers, building new proteins to keep the cell running.	eukaryotic cell	What analogy is used to explain eukaryotic cell?
A eukaryotic cell is like a city. The nucleus is the mayor, and it controls all of the other parts of the cell. The mitochondria are like factories, and they produce energy for the cell. The cytoplasm is like the streets, and it connects everything else together.	eukaryotic cell	What analogy is used to explain eukaryotic cell?
The analogy of the city is often used to explain the eukaryotic cell. The cell wall can be thought of as the city limits, while the plasma membrane is like the security fence around the city. The cytoplasm can be thought of as all of the buildings and land within the city limits, while the organelles are like individual rooms or offices in those buildings.	eukaryotic cell	What analogy is used to explain eukaryotic cell?
A eukaryotic cell is like a city. It has different parts that work together to keep the cell functioning. The nucleus is the control center, similar to the mayor of a city. The mitochondria are like power plants, and they produce energy for the cell. The cytoplasm is like the streets, and it connects all of the different parts of the cell together.	eukaryotic cell	What analogy is used to explain eukaryotic cell?
A eukaryotic cell is like a city. Cities are made up of many different parts that all work together to make the city run. The same is true for a eukaryotic cell. It has many different parts that all work together to keep the cell running.	eukaryotic cell	What analogy is used to explain eukaryotic cell?
A prokaryotic cell is like a small factory. It has all the equipment it needs to make proteins, including the instructions in its DNA.	prokaryotic cell	What analogy is used to explain prokaryotic cell?
A prokaryotic cell is like a city without a mayor. The cells communicate with one another and carry out the functions of the city, but there is no centralized control.	prokaryotic cell	What analogy is used to explain prokaryotic cell?
A prokaryotic cell is like a small city. It has many different parts that work together to keep the cell alive and functioning.	prokaryotic cell	What analogy is used to explain prokaryotic cell?
A prokaryotic cell is like a small factory. It has all the machines it needs to make new cells and products inside it.	prokaryotic cell	What analogy is used to explain prokaryotic cell?
A prokaryotic cell is similar to a city. The cytoplasm is the downtown area and it contains all of the essential components for life, such as DNA, ribosomes, and enzymes. The plasma membrane is like the city limits; it separates the inside of the cell from the outside world. The cell wall is like a fence that surrounds the city; it helps protect against invaders and maintains the shape of the cell.	prokaryotic cell	What analogy is used to explain prokaryotic cell?
In computing, an operating system kernel is the core of a computer operating system. It is responsible for managing hardware and software resources and providing common services for application programs. The kernel performs its tasks in cooperation with device drivers, which are modules that load into the kernel to provide specific functions, such as access to the disk drive or network card.	operating systems kernel	What analogy is used to explain operating systems kernel?
An analogy to explain the kernel of an operating system is that it is like the brain of a human. It controls all of the important functions of the body and handles all communication between different parts of the body.	operating systems kernel	What analogy is used to explain operating systems kernel?
One analogy is to think of the kernel as the brains of a computer. Just as your brain controls all the functions of your body, the kernel controls all the functions of the computer.	operating systems kernel	What analogy is used to explain operating systems kernel?
A kernel is the central part of an operating system. It manages memory, devices, and processes, and provides essential services to applications. Just as the heart is the vital center of the human body, so the kernel is the vital center of a computer system.	operating systems kernel	What analogy is used to explain operating systems kernel?
A kernel is like the brain of a computer. It controls all the functions of the system and coordinates communication between different parts of the machine.	operating systems kernel	What analogy is used to explain operating systems kernel?
An analogy to explain limiting reactant is that it is like a pie. If you have two pies, and want to give each person half of a pie, you would cut eachpie into fourths. However, if you only have one pie, and want to give each person half of a pie, you would cut the pie in eighthsof pieces. This is because there are more people who want part of the onepie than there are people who want part of the two pies. In the same way, there are more moleculesof A that can react with B molecules than there are B molecules availableto react. So A becomes the limiting reactant.	limiting reactant	What analogy is used to explain limiting reactant?
An analogy that is often used to explain limiting reactant is a block party. If only one person brings the blocks and everyone else wants to play, then there will not be enough blocks for everyone to play. The same is true with reactants in a chemical reaction. If one reactant runs out, the reaction will stop.	limiting reactant	What analogy is used to explain limiting reactant?
A reaction can be represented by an equation in which a reactant is converted to product. In order for the reaction to occur, each molecule of the reactant must come into contact with another molecule of the reactant. If all of the molecules of the reactant are not used up in this way, then some will remain and the reaction will not proceed to completion. The amount of product formed is directly proportional to the amount of reactant consumed. This relationship can be expressed mathematically as:where k is a constant that depends on the particular reaction under consideration.This relationship can also be visualized using an analogy involving bowling pins. Consider a set-up in which 10 bowling pins are arranged in a triangle, as shown below.If one ball is bowled at these pins, it is likely that only a few will be knocked down since there are so many pins (thereactants). However, if two balls are bowled at these pins, it is much more likely that all 10pins will be knocked over (the products), because there are fewerpins remaining after the first ball has been bowled. In other words, doublingthe number of balls doubles the probabilityof knocking over all 10pins. This analogy illustrates how increasing thenumber of molecules (balls) increases thenumber of successful collisions(knocks down more bowling pins).	limiting reactant	What analogy is used to explain limiting reactant?
An analogy used to explain limiting reactant is a scenario where there are ten people who want to cross a bridge. If the bridge can only hold five people, then at some point not all of the people will be able to cross the bridge. This is analogous to a chemical reaction where two substances collide and create a new substance. At some point, one of the substances will run out and the reaction will stop.	limiting reactant	What analogy is used to explain limiting reactant?
The analogy of a bucket of water that has a hole in the bottom is used to explain limiting reactant. The more water you pour into the bucket, the faster it will drain out because there is already a hole present. In this analogy, the water represents the reactants and the hole represents the limiting reactant.	limiting reactant	What analogy is used to explain limiting reactant?
An analogy to explain helicase would be a person turning the pages of a book. The person is analogous to the helicase enzyme and the pages of the book are analogous to DNA.	helicase	What analogy is used to explain helicase?
Helicase is a protein that helps DNA to unzip, or separate, so that the genetic instructions within it can be copied. Helicase works like a zipper on a coat. It zips open the two halves of the DNA molecule and then copies the genetic instructions from one half to the other.	helicase	What analogy is used to explain helicase?
The analogy of helicase to a lock and key is used to explain how the enzyme unwinds DNA. The lock is the helix that the DNA strands wrap around and the key is helicase which unlocks it by breaking the hydrogen bonds between nucleotides.	helicase	What analogy is used to explain helicase?
A helicase is a protein that unwinds DNA strands like a zipper.	helicase	What analogy is used to explain helicase?
A helicase enzyme is like a motor that uses energy to unzip DNA strands.	helicase	What analogy is used to explain helicase?
Replication proteins are compared to the hands of a clock. The hands help turn the gears that make the clockwork run. In replication, the proteins bind to DNA and help it unwind so that it can be copied.	dna replication binding proteins	What analogy is used to explain dna replication binding proteins?
A protein is like a key, and the dna molecule is like a lock. The protein fits perfectly into the lock, and when it does, it causes the door to open so that the DNA can be copied.	dna replication binding proteins	What analogy is used to explain dna replication binding proteins?
A protein is like a key, and the DNA molecule is like a lock. The proteins are responsible for finding and locking onto specific sites on the DNA molecule to allow replication to occur.	dna replication binding proteins	What analogy is used to explain dna replication binding proteins?
One analogy is that of a group of people in a large room, each with a copy of the same document. The people are all looking for someone who also has a copy of the document. Once they find that person, they bind themselves to that person and share the copies of the document.	dna replication binding proteins	What analogy is used to explain dna replication binding proteins?
Replication binding proteins are likened to a pair of hands. The DNA is like a ball of yarn, and the replication binding proteins are the fingers that keep the DNA from unraveling.	dna replication binding proteins	What analogy is used to explain dna replication binding proteins?
A ligase is a type of enzyme that helps to bind two pieces of DNA together. This analogy can help explain how ligases work: imagine you have two long pieces of string and you want to bind them together. You can do this by using a small piece of string to tie the two strings together. The small piece of string is like the ligase, it helps to bind the two larger pieces of string together.	ligase	What analogy is used to explain ligase?
A ligase is a type of enzyme that helps to join two pieces of DNA together. It can be compared to a glue gun, which helps to attach two pieces of paper together.	ligase	What analogy is used to explain ligase?
Ligase is used to connect two pieces of DNA. It can be thought of as a zipper, connecting the two strands together.	ligase	What analogy is used to explain ligase?
A ligase is a type of enzyme that catalyzes the joining of two pieces of DNA or RNA. It can be compared to a glue, which binds two objects together.	ligase	What analogy is used to explain ligase?
Ligase is to DNA as a shoehorn is to a shoe.	ligase	What analogy is used to explain ligase?
A process control block (PCB) is a data structure in a computer operating system that describes an active process, its state, and the resources it uses. It also contains information about the shared memory segments assigned to the process.	process control block	What analogy is used to explain process control block?
A process control block (PCB) is a data structure in a computer operating system that describes the state of one or more processes. A PCB is created for each process when it starts, and contains information such as the process's identifier, priority, CPU time usage, memory usage, open files etc.	process control block	What analogy is used to explain process control block?
A process control block (PCB) is a data structure in a computer operating system that describes the state of one or more processes. The PCB includes information about the process's environment, including its open files and active threads.	process control block	What analogy is used to explain process control block?
A process control block (PCB) is a data structure in a computer operating system that stores information about a process, such as the state of the process, its CPU time usage, and memory usage.	process control block	What analogy is used to explain process control block?
A process control block (PCB) is a data structure in a computer operating system that describes the state of one or more processes. A PCB includes information about the process, such as its current status and memory address.	process control block	What analogy is used to explain process control block?
The analogy used to explain message encoding is a post office. Messages are sent through the mail system in an envelope with a specific address. The postal worker delivers the letter to the correct house by reading the address on the envelope. In a similar way, messages are encoded and transmitted using specific protocols so that they can be delivered to the correct destination.	message encoding	What analogy is used to explain message encoding?
The analogy of mail is used to explain message encoding. When you send a letter, the postal service encodes the address on the envelope so that it can be delivered to the correct location. Similarly, when you send a message over the internet, your computer encodes the message into a format that can be understood by the recipient's computer.	message encoding	What analogy is used to explain message encoding?
An analogy used to explain message encoding is that of a mail carrier. The mail carrier takes the letter and delivers it to the correct house. In the same way, encoding takes the message and delivers it to the correct destination.	message encoding	What analogy is used to explain message encoding?
A message is like a letter. The sender writes the letter, puts it in an envelope, and addresses it to a specific person. The sender can also put a stamp on the envelope to help pay for postage. To send the letter, the sender puts it in a mailbox and closes the door.	message encoding	What analogy is used to explain message encoding?
A message is like a letter that is sent through the mail. The sender writes the letter, puts it in an envelope, and addresses it to the recipient. The postal worker takes the letter from the sender and puts it in a bag with other letters for that destination. The postal worker then takes the bag to a plane or truck and delivers it to the recipient's mailbox.	message encoding	What analogy is used to explain message encoding?
A lock and key analogy is often used to explain how drugs interact with receptor sites. The drug can be thought of as the key, while the receptor site is the lock.	interaction between drugs and receptor sites	What analogy is used to explain interaction between drugs and receptor sites?
The analogy used to explain interaction between drugs and receptor sites is that of a lock and key. The drug is the key, and the receptor site is the lock.	interaction between drugs and receptor sites	What analogy is used to explain interaction between drugs and receptor sites?
A lock and key analogy is used to explain interaction between drugs and receptor sites. The drug is the key, and the receptor site is the lock.	interaction between drugs and receptor sites	What analogy is used to explain interaction between drugs and receptor sites?
The analogy of a key in a lock is often used to explain how drugs interact with receptor sites.	interaction between drugs and receptor sites	What analogy is used to explain interaction between drugs and receptor sites?
A lock and key analogy is often used to explain how drugs interact with receptor sites. The drug is the key, while the receptor site is the lock.	interaction between drugs and receptor sites	What analogy is used to explain interaction between drugs and receptor sites?
A monitor is like a television screen. It shows the computer user what is happening on the computer.	monitor	What analogy is used to explain monitor?
A monitor is like a television screen. It displays images that have been sent to it from a computer.	monitor	What analogy is used to explain monitor?
A monitor is like a television set. It is used to view images and videos.	monitor	What analogy is used to explain monitor?
A monitor is used to compare the output of two or more things.	monitor	What analogy is used to explain monitor?
A monitor is like a television.	monitor	What analogy is used to explain monitor?
A CPU can be compared to a worker in an office. The worker is given a task to do and then starts working on it. While the worker is working on the task, he or she interrupts their work every once in a while to answer the phone or talk to someone who walks into the office. However, as soon as the phone call or conversation is over, the worker goes back to work on the original task.	cpu	What analogy is used to explain cpu?
A cpu can be thought of as the "brain" of a computer. It handles all of the instructions that need to be carried out in order for the computer to function.	cpu	What analogy is used to explain cpu?
A CPU can be thought of as a large group of people all working together to solve a problem. Just like with people, the more CPUs you have working on a problem, the faster it will get solved.	cpu	What analogy is used to explain cpu?
A CPU is like a chef in a restaurant. The chef decides what meals to cook, how to prepare them, and when they will be served. The CPU does the same thing with computer programs: it decides which instructions to run, how to run them, and when they will be executed.	cpu	What analogy is used to explain cpu?
A CPU can be thought of as a small group of people who are all working together to solve a problem. Just like with any group of people, some will be better at solving certain problems than others. And, just like in real life, the more people you have working on something, the faster it will get done.	cpu	What analogy is used to explain cpu?
The motherboard is to a computer as the skeleton is to the human body. The skeleton provides structure and support for the body, while the motherboard does the same for a computer. Additionally, just as muscles attach to bones and allow us to move, computing devices connect to the motherboard and allow us to interact with them.	motherboard	What analogy is used to explain motherboard?
A motherboard can be thought of as the brain of a computer. It is responsible for controlling all of the other components that make up the system.	motherboard	What analogy is used to explain motherboard?
A motherboard can be thought of as the brain of a computer. It is the main circuit board in a desktop or laptop and it houses all of the key components including the processor, memory, and graphics card.	motherboard	What analogy is used to explain motherboard?
A motherboard can be thought of as the brain of a computer. It is the main circuit board that everything else plugs into. The motherboard controls all communications between components and also contains the CPU, RAM, BIOS, and connectors for hard drives, optical drives, displays, and other peripherals.	motherboard	What analogy is used to explain motherboard?
A motherboard can be thought of as the "brain" of a computer. It is a circuit board that contains the main components of a computer, such as the CPU, memory, and ports.	motherboard	What analogy is used to explain motherboard?
Ram is used to explain how a computer processes information.	ram	What analogy is used to explain ram?
Ram is used as an analogy to explain the function of a computer's memory. Just as ram stores information temporarily so that the computer can access it quickly, computer memory stores information permanently so that the CPU can access it quickly.	ram	What analogy is used to explain ram?
A computer's memory is much like a desk. The desk has a number of drawers in it, and each drawer can hold different things. For example, one drawer might have paper clips while another might have staplers. Each time you want to use something from the desk, you need to open the right drawer and find what you're looking for. In the same way, when your computer wants to use some information it needs to go into its memory and find the right place to get it.	ram	What analogy is used to explain ram?
Ram is like a car that has been in an accident. The front end of the car is smashed, and it will not work properly anymore.	ram	What analogy is used to explain ram?
A ram is someone who butt heads with people.	ram	What analogy is used to explain ram?
A power supply unit can be thought of as the heart of a computer. Just as the heart circulates blood throughout the body, a power supply unit circulates electricity throughout a computer.	power supply unit	What analogy is used to explain power supply unit?
A power supply unit is often compared to a tank of water. Just as the tank can be filled with a limited amount of water, a PSU has a finite amount of power that it can provide. Once the tank is emptied, no more water will flow until more is added. The same goes for a PSU; once its power output has been used up, no more energy will be available until the unit is recharged.	power supply unit	What analogy is used to explain power supply unit?
A power supply unit is like a gas tank in a car. It stores energy until it is needed to turn the engine on.	power supply unit	What analogy is used to explain power supply unit?
A power supply unit is often compared to a water pump. Just like a water pump supplies water to a faucet, a power supply unit provides electricity to components in a computer.	power supply unit	What analogy is used to explain power supply unit?
Here is an analogy to help explain what a power supply unit (PSU) does. A PSU can be thought of as the heart of a computer system. Just as the heart circulates blood throughout the body, the PSU circulates electricity throughout the computer system. The PSU converts AC power from the wall outlet into DC power that is needed by all of the components in a computer system.	power supply unit	What analogy is used to explain power supply unit?
A keyboard is like a piano.	keyboard	What analogy is used to explain keyboard?
Keyboard is like a piano.	keyboard	What analogy is used to explain keyboard?
One analogy for a keyboard is that it is like a piano. The keys are arranged in the same way on both instruments, and when they are played, they produce notes corresponding to the black and white keys on a piano.	keyboard	What analogy is used to explain keyboard?
A keyboard is like a piano. The keys are pressed to create music.	keyboard	What analogy is used to explain keyboard?
A keyboard is often compared to a piano. Just as the keys of a piano can be pressed down to produce different notes, the keys on a keyboard can be used to type letters and numbers.	keyboard	What analogy is used to explain keyboard?
A mouse is to a computer as a remote control is to a TV.	mouse	What analogy is used to explain mouse?
A mouse is like a tiny person who lives in your computer.	mouse	What analogy is used to explain mouse?
A mouse is like a tiny person that lives inside your computer.	mouse	What analogy is used to explain mouse?
To explain mouse, a computer analogy is often used. Mouse is like the cursor on your computer screen. It helps you navigate and select different things on the screen.	mouse	What analogy is used to explain mouse?
A mouse is a small, furry creature that scurries around in search of food. It is often used as a symbol for fear or vulnerability.	mouse	What analogy is used to explain mouse?
An analogy to explain an audio card is that it is like a driver's license. It proves that you are allowed to operate the equipment.	audio card	What analogy is used to explain audio card?
An audio card is like a microphone. It takes the sound that is created by your voice and turns it into electronic signals that can be understood by your computer.	audio card	What analogy is used to explain audio card?
An audio card is like a sound system for your computer.	audio card	What analogy is used to explain audio card?
A sound card can be compared to a train conductor. Just as the conductor directs traffic and ensures that passengers are safe, the sound card controls audio signals and makes sure they reach the correct destination.	audio card	What analogy is used to explain audio card?
An analogy to explain an audio card is that it is like a translator between the language of computers and the language of sound.	audio card	What analogy is used to explain audio card?
A video card can be thought of as the "heart" of a computer. It is responsible for processing all the graphics and images that are displayed on the monitor.	video card	What analogy is used to explain video card?
A video card is sort of like a CPU, but it is specifically designed to deal with graphics. It has its own processor and memory, which helps it handle the complex tasks of creating images on your screen.	video card	What analogy is used to explain video card?
A video card is like a printer for your computer. It takes the digital information from the computer and creates a picture on the screen.	video card	What analogy is used to explain video card?
A video card is like a car. It has different parts that all work together to make it run. The engine is the part that does all the work, while the other parts help it run better.	video card	What analogy is used to explain video card?
A video card is a lot like the engine of a car. It takes data from the computer and processes it so that you can see it on the screen.	video card	What analogy is used to explain video card?
A tree's age calculation is similar to a person's age calculation. A tree starts with a 0 (birthday) and every year it adds 1 to its age.	tree's age calculation	What analogy is used to explain tree's age calculation?
The analogy used to explain tree's age calculation is the counting of a human's birthdays. Just as people are one year older on their birthday, trees add one year to their age every 365 days.	tree's age calculation	What analogy is used to explain tree's age calculation?
The tree's age calculation is similar to a human's age calculation. Just as humans calculate their age by counting the number of years since they were born, trees calculate their age by counting the number of rings in their trunk.	tree's age calculation	What analogy is used to explain tree's age calculation?
The tree analogy is used to explain how scientists calculate a tree's age. Scientists can determine the age of a tree by counting the number of growth rings in its trunk. The width of each ring corresponds to the amount of time that has passed since the tree's last growth spurt.	tree's age calculation	What analogy is used to explain tree's age calculation?
The growth rings of a tree can be used to determine its age. Each ring represents one year's growth, so the number of rings can be used to calculate the tree's age.	tree's age calculation	What analogy is used to explain tree's age calculation?
The analogy used to explain glycolysis is that it is a lot like the process of making coffee. The coffee beans are ground up, and hot water is poured over them. This causes the beans to release their flavor and caffeine. In the same way, glucose (the bean) is broken down into its component parts (sugar and caffeine) in glycolysis.	glycolysis	What analogy is used to explain glycolysis?
The analogy of glycolysis is that it is like a fire. The glucose and oxygen are the fuel for the fire, and the heat released by the reaction is the energy that drives all cellular processes.	glycolysis	What analogy is used to explain glycolysis?
The analogy of a marathon runner is used to explain glycolysis. The marathon runner starts the race by running at a fast pace. However, as the race progresses, the runner begins to slow down and tire. At the same time, the energy reserves in their body are gradually depleted. In order to finish the race, the runner must eventually resort to using energy sources that are stored in their muscles (glycogen).	glycolysis	What analogy is used to explain glycolysis?
The analogy of glycolysis is that it is like a car. The glucose in the blood is like the gasoline, and the pyruvate is like the exhaust.	glycolysis	What analogy is used to explain glycolysis?
Glycolysis is like a bank. Enzymes are like tellers who help money move in and out of the bank. Glucose is like money, and ATP is like currency that can be used to buy things.	glycolysis	What analogy is used to explain glycolysis?
The analogy used to explain anti-stokes scattering is that of two cars driving towards each other on a road. The front car slows down as the back car speeds up, and eventually they meet in the middle. In the same way, light particles can scatter off one another in an anti-stokes pattern where the energy of the light is transferred from the high energy particle to the low energy particle.	anti-stokes scattering	What analogy is used to explain anti-stokes scattering?
The analogy used to explain anti-stokes scattering is that of a ball being thrown into a pond. The ripples created by the ball are analogous to the light waves emitted from an object. The anti-stokes ripple is created when another object, such as a hand, pushes against the original ripple. This creates a secondary wave that travels in the opposite direction of the original wave. Analogously, anti-stokes scattering occurs when light waves interact with each other and create secondary waves that travel in the opposite direction of the original waves.	anti-stokes scattering	What analogy is used to explain anti-stokes scattering?
The analogy used to explain anti-stokes scattering is that of a person trying to shout at a friend who is far away. The sound waves created by the person's voice will be scattered in all directions, making it difficult for the friend to hear what is being said. In the same way, light waves are scattered in all directions when they pass through a material with an inhomogeneous distribution of particles. This makes it difficult for light waves to travel in a straight line, and leads to an increase in the amount of energy required to move them forward (i.e., an increase in the intensity of the light).	anti-stokes scattering	What analogy is used to explain anti-stokes scattering?
The analogy used to explain anti-stokes scattering is the comparison of a bowling ball being thrown at a group of pins. The ball (representing light) is thrown and hits the first pin (representing an atom). The force of the impact causes the other pins to scatter. Some of the scattered energy goes back in the direction of the bowling ball, while some goes off in other directions. In anti-stokes scattering, most of the scattered energy goes back in the direction of the light source.	anti-stokes scattering	What analogy is used to explain anti-stokes scattering?
The analogy used to explain anti-stokes scattering is that of a person throwing a ball into a crowd. The person throwing the ball is the light source and the people in the crowd are the atoms or molecules that make up the sample. When someone catches the ball, they pull it back towards themselves. This is similar to how photons are scattered by atoms and molecules, which pulls them back towards themselves. Anti-stokes scattering occurs when an atom or molecule emits a photon, which pushes the photon away from itself.	anti-stokes scattering	What analogy is used to explain anti-stokes scattering?
The analogy to explain stokes scattering is that of a boat on a river. The boat represents the light waves and the river represents the medium through which the light waves are travelling. When the boat moves quickly through the water, it creates ripples or waves. These ripples represent the light waves that are being scattered.	stokes scattering	What analogy is used to explain stokes scattering?
The analogy used to explain stokes scattering is that of a car driving on a road. The headlights on the car are analogous to the photons emitted from a laser, and the road is analogous to the medium through which light travels. When the car drives down the road, the headlights scatter off objects in their path. This same phenomenon occurs with light travelling through a medium, and photons will scatter off particles in their path.	stokes scattering	What analogy is used to explain stokes scattering?
An analogy to explain stokes scattering is that it is similar to a person throwing a rock into a still pond. The rock will cause ripples in the water that will move outward from where the rock was thrown.	stokes scattering	What analogy is used to explain stokes scattering?
A light bulb is analogy to a star. The scattering of the light from the star is like the scattering of light from the light bulb.	stokes scattering	What analogy is used to explain stokes scattering?
A soccer ball is kicked at a wall. The ball scatters off the wall in many directions. This is an example of stokes scattering.	stokes scattering	What analogy is used to explain stokes scattering?
If you imagine a room filled with 100 people, and 49 of them are wearing blue shirts and 51 are wearing red shirts, the median lethal dose would be the dose at which 50% of the people in the room die. In this analogy, blue shirt wearers represent those who survive a dosage of the drug, while red shirt wearers represent those who die from it.	median lethal dose	What analogy is used to explain median lethal dose?
The median lethal dose is the amount of a substance that will kill 50% of those exposed to it.	median lethal dose	What analogy is used to explain median lethal dose?
A median lethal dose, or LD50, is an analogy used to explain the measure of a substance's toxicity. In order to determine a substance's LD50, scientists expose a group of test animals to different doses of the substance and then observe which dose kills half of the animals. The lower the LD50 number, the more toxic the substance is.	median lethal dose	What analogy is used to explain median lethal dose?
The median lethal dose is the amount of a substance required to kill half of the individuals exposed to it. This analogy can be used to explain how a vaccine works. When you are vaccinated, you are given a small dose of the virus or disease. This allows your body to build up immunity and protect you from future exposure.	median lethal dose	What analogy is used to explain median lethal dose?
The analogy used to explain median lethal dose is a comparison of the amount of a substance required to kill 50% of the population to the amount required to kill 100% of the population.	median lethal dose	What analogy is used to explain median lethal dose?
The analogy for the universe is a tree. The roots are at the bottom of the tree, and they grow and spread out. The branches grow up from the roots and extend outwards. The leaves grow on the branches, and they get sunlight from the sun. Just like a tree needs all of its parts to survive, the universe needs all of its parts to exist.	universe	What analogy is used to explain universe?
The analogy of the universe is like a big computer. It has many different parts that all work together to make it run.	universe	What analogy is used to explain universe?
The analogy of the universe is often compared to a giant tree. The roots of the tree are at the center of the earth, and as you move away from the center, the branches get bigger and bigger. This is similar to how galaxies are spread out in space.	universe	What analogy is used to explain universe?
The analogy of the universe is that it is like a big chicken coop. The chickens are the planets and stars and the coop is the space that they live in.	universe	What analogy is used to explain universe?
The analogy of the universe is often compared to a giant tree. The tree has a large trunk with many smaller branches and leaves. In the same way, the universe has a large central body (the sun) with many orbiting planets and moons.	universe	What analogy is used to explain universe?
An analogy to explain enzyme mechanism is that of a lock and key. The enzyme is the lock and the substrate is the key.	enzyme mechanism	What analogy is used to explain enzyme mechanism?
Analogy to a lock and key: The enzyme is the lock, and the substrate is the key.	enzyme mechanism	What analogy is used to explain enzyme mechanism?
A lock and key analogy is often used to explain how enzymes work. The enzyme is the lock, while the substrate (the molecule it acts on) is the key. The enzyme fits perfectly over the substrate like a key in a lock, and then starts to change its shape as it bonds with the substrate. This allows it to start working on breaking down or building up the molecule.	enzyme mechanism	What analogy is used to explain enzyme mechanism?
Enzyme mechanism is similar to that of a lock and key. The enzyme is the lock and the substrate is the key.	enzyme mechanism	What analogy is used to explain enzyme mechanism?
The enzyme mechanism is like a lock and key. The substrate is the key and the enzyme is the lock.	enzyme mechanism	What analogy is used to explain enzyme mechanism?
An analogy is used to explain anova as follows: anova is similar to a courtroom trial. There are three types of trials that can take place- criminal, civil, and family. Criminal trials are for people who have been accused of breaking the law. Civil trials are for people who have been involved in a disagreement or dispute with another person or company. Family trials are for parents who are trying to figure out custody arrangements for their children after a divorce. In each type of trial, there is a prosecutor and defense attorney who argue their case before a judge or jury. Anova works in the same way- there is a researcher (the prosecutor) and the participants (the defense attorneys) who argue their case before a panel of experts (the judge/jury).	anova	What analogy is used to explain anova?
An analogy for anova is to think of it as a three-legged race. In this analogy, the two people represent the groups being compared and the racecourse is the statistician's test. The people are racing against each other to see who can cross the finish line first. If one person falls down, that person still has a chance of winning if the other person also falls down. This is similar to how anova works; even if one group has a smaller difference than the other group, that group can still win if there is enough variability in the data.	anova	What analogy is used to explain anova?
A popular analogy used to explain the concept of ANOVA is that of a fair coin. When flipping a fair coin, there is an equal chance for the coin to land on heads or tails (50/50). In the same way, when running an ANOVA test, there is an equal chance for each group being different from one another (i.e., there is no “right” answer).	anova	What analogy is used to explain anova?
A popular analogy used to explain anova is that of a fair coin. In this analogy, the null hypothesis would be that the coin is fair, while the alternative hypothesis would be that the coin is not fair (i.e., it has a bias). An anova test would be used to determine whether there is evidence for a difference between the two hypotheses.	anova	What analogy is used to explain anova?
An analogy to help explain the results of an ANOVA is that of a football game. In any given football game, different players will perform better or worse than others. However, at the end of the game, we can look at the final score and see how each player performed as a whole. This is similar to what an ANOVA does; it looks at the average performance of all the players (in this case, all the treatments) in order to determine if there is a difference between them.	anova	What analogy is used to explain anova?
A thermostat is like a person's body. When the person gets too hot, they sweat to cool down. When the person gets too cold, they shiver to warm up.	thermostat	What analogy is used to explain thermostat?
A thermostat is a device used to regulate the temperature of a system. It can be compared to the governor on an engine, which regulates the speed of the engine by controlling how much fuel is supplied.	thermostat	What analogy is used to explain thermostat?
A thermostat is used to regulate the temperature of a room. It can be compared to a person's body temperature. When the person's body temperature gets too high, they will sweat in order to cool down. When the thermostat senses that the room's temperature has gotten too high, it will turn on the air conditioning unit to cool down the room.	thermostat	What analogy is used to explain thermostat?
The thermostat analogy is used to explain how the brain works. The thermostat analogy states that the brain is like a thermostat that regulates the body's temperature.	thermostat	What analogy is used to explain thermostat?
A thermostat is a device that regulates the temperature of a room by turning on or off the furnace or air conditioner.	thermostat	What analogy is used to explain thermostat?
A balance scale analogy is used to explain chemical equilibrium.	chemical equilibrium	What analogy is used to explain chemical equilibrium?
The analogy of a balance scale is used to explain chemical equilibrium.	chemical equilibrium	What analogy is used to explain chemical equilibrium?
Chemical equilibrium is similar to a balance scale. In order for each side of the scale to be equal, the weights on both sides must be balanced. In chemical equilibrium, the concentrations of reactants and products are balanced.	chemical equilibrium	What analogy is used to explain chemical equilibrium?
A balance scale analogy is used to explain chemical equilibrium. In a balance scale, two weights are placed on either side of a fulcrum, and the object is balanced when the weights are equal. Similarly, in chemical equilibrium, two opposing processes (such as forward and reverse reactions) occur at the same rate so that there is no net change in the system.	chemical equilibrium	What analogy is used to explain chemical equilibrium?
The analogy used to explain chemical equilibrium is that of a tug-of-war. In this analogy, each team represents the reactants and products of a chemical reaction. The teams are evenly balanced at the start of the game, but as they pull on the rope, one side begins to gain an advantage. However, as soon as one side begins to win too easily, the other side starts to fight back, evening out the teams once again. This process continues until both sides reach a state of equilibrium, where neither side is winning or losing any more battles.	chemical equilibrium	What analogy is used to explain chemical equilibrium?
Just-in-time is a business model that uses principles of lean manufacturing to optimize the flow of materials and goods through a production process.	just-in-time	What analogy is used to explain just-in-time?
An analogy used to explain just-in-time is that it is like a grocery store. Grocery stores do not have a lot of food in their store at any given time, but they always have what you need when you need it because they get new shipments every day.	just-in-time	What analogy is used to explain just-in-time?
Just-in-time is often explained using the analogy of a grocery store. Imagine that you go to the grocery store and only pick up what you need for that day. You don't buy any food that will spoil or go bad. This is similar to just-in-time production.	just-in-time	What analogy is used to explain just-in-time?
Just-in-time is often compared to a supermarket. In order for the supermarket to remain stocked with food, it must receive shipments of food on a regular basis. However, the store does not want to have too much food on hand, because that would mean that they are wasting money by having food spoil. So instead of receiving large shipments of food all at once, the supermarket receives smaller shipments throughout the day. This way, they can ensure that they always have enough food in stock without having any excess.	just-in-time	What analogy is used to explain just-in-time?
A car factory analogy is often used to explain just-in-time. In a car factory, parts are not stored in the factory itself. Instead, they are delivered "just in time" as needed from suppliers. The same principle applies to just-in-time inventory management in business: Suppliers deliver goods "just in time" so that there is no excess inventory sitting around taking up space and costing money.	just-in-time	What analogy is used to explain just-in-time?
The analogy of adaptive immunity is that it is like a lock and key. The key (adaptive immunity) fits perfectly into the lock (innate immunity) and can open it.	adaptive immunity	What analogy is used to explain adaptive immunity?
The analogy of adaptive immunity is that it is like a city with a police force. The immune system recognizes and destroys pathogens (the bad guys) before they can cause harm.	adaptive immunity	What analogy is used to explain adaptive immunity?
The adaptive immune system is like a security guard. It remembers the faces of everyone who has ever tried to attack the body, and it can quickly recognize those faces if they come back.	adaptive immunity	What analogy is used to explain adaptive immunity?
The analogy of adaptive immunity is comparing it to a city. The city has different parts that all work together to make the city function. If one part of the city is destroyed, the other parts can continue to function. This is similar to how our immune system works. If we are exposed to a virus, our body's adaptive immune system will recognize the virus and attack it.	adaptive immunity	What analogy is used to explain adaptive immunity?
Analogy of adaptive immunity is that it is like a computer system. The body’s immune cells are constantly monitoring the environment for invaders, and when they find them, they remember how to fight them off so that the next time they show up, the immune cells already know what to do.	adaptive immunity	What analogy is used to explain adaptive immunity?
The analogy used to explain Ohm's law is a water hose. If the water pressure (voltage) is high, then more water will come out of the hose. If the water pressure is low, then less water will come out of the hose. The same principle applies to electricity; if the voltage is high, then more current will flow through the wire, and if the voltage is low, then less current will flow through the wire	ohm's law	What analogy is used to explain ohm's law?
A resistor in a circuit is like the water valve in your house. When you turn on the faucet, water flows until it reaches a certain pressure. The more water that flows, the higher the pressure gets. In an electrical circuit, current (the amount of electricity flowing) is measured in amps, and voltage (or potential difference) is measured in volts. Just as with water, when there's more current flowing through a resistor, the voltage rises.	ohm's law	What analogy is used to explain ohm's law?
An analogy to explain Ohm's law is that of a water hose. If the hose is turned on all the way, the water flows out quickly. If the hose is only turned partly on, then less water comes out. This same idea applies to electricity. When you turn on an electrical appliance all the way, it uses more electricity than if you only turn it on partway.	ohm's law	What analogy is used to explain ohm's law?
An analogy used to explain Ohm's law is a water hose. The higher the water pressure at the faucet, the faster the water will flow through the hose. The same is true for electricity flowing through a wire. The higher the voltage (pressure), the more current (flow) will flow through the wire.	ohm's law	What analogy is used to explain ohm's law?
Electricity is like water. Just as the amount of water flowing through a pipe depends on the size of the pipe and the water pressure, so too does the amount of electricity flowing through a wire depend on its size and voltage.	ohm's law	What analogy is used to explain ohm's law?
The analogy of transcription is similar to that of a secretary taking dictation. The DNA molecule is the boss, and the RNA molecule is the secretary. The DNA provides the instructions for building a protein, and the RNA copies these instructions so that they can be used to build the protein.	transcription	What analogy is used to explain transcription?
A transcription factor is a protein that binds to DNA and helps control the activity of specific genes. Transcription factors can be compared to construction workers who help build a house. The DNA is like the blueprint for the house, and the transcription factors are like the construction crew who follow the blueprint to build it.	transcription	What analogy is used to explain transcription?
The analogy of transcription is the process of taking a written text and turning it into an audio file.	transcription	What analogy is used to explain transcription?
Replication of DNA is similar to photocopying a document. The original is copied, and each copy has the same information as the original.	transcription	What analogy is used to explain transcription?
Transcription is similar to taking dictation.	transcription	What analogy is used to explain transcription?
Rna polymerase is like a construction worker. It builds rna molecules by stringing together small pieces of rna called nucleotides.	rna polymerase	What analogy is used to explain rna polymerase?
Rna polymerase is like a secretary taking dictation.	rna polymerase	What analogy is used to explain rna polymerase?
A molecular machine that copies strands of DNA by reading the genetic code and assembling new strands of RNA.	rna polymerase	What analogy is used to explain rna polymerase?
One analogy used to explain RNA polymerase is that it is like a typewriter. The enzyme can "read" the genetic information in DNA and use it to create new RNA molecules.	rna polymerase	What analogy is used to explain rna polymerase?
A possible analogy for RNA polymerase is a baker. The baker has many ingredients (nucleotides) and recipes (DNA sequences). The baker assembles the ingredients according to the recipe, resulting in a cake. In the same way, RNA polymerase assembles nucleotides into an RNA molecule following a DNA sequence.	rna polymerase	What analogy is used to explain rna polymerase?
Ribosomes are like construction workers, they build the proteins that make up our cells.	ribosome	What analogy is used to explain ribosome?
Ribosomes are like construction workers on a building site, they read the instructions (the DNA) and build the protein according to these.	ribosome	What analogy is used to explain ribosome?
The analogy used to explain ribosomes is that they are like factories. They produce proteins by reading the instructions found in genes.	ribosome	What analogy is used to explain ribosome?
Ribosomes are like machines that build other machines.	ribosome	What analogy is used to explain ribosome?
The ribosome is like a construction crew that builds proteins.	ribosome	What analogy is used to explain ribosome?
An activator protein is a bit like an ignition key for a car. It starts the process of gene expression by binding to the promoter region of a gene and then recruiting other proteins that will help to turn on the gene.	activator protein	What analogy is used to explain activator protein?
The analogy of activator protein is that it is a key. The activator protein binds to the promoter region of the gene and unlocks it, which then allows transcription to take place.	activator protein	What analogy is used to explain activator protein?
An analogy to explain activator protein is that it is like a key. The activator protein is responsible for unlocking the genes that are necessary for cell division. Without the activator protein, the cells would not be able to divide and multiply.	activator protein	What analogy is used to explain activator protein?
One analogy used to explain activator protein is that it is like a key that unlocks the door to DNA.	activator protein	What analogy is used to explain activator protein?
One analogy used to explain activator protein is that of a key and a lock. The activator protein is the key, and it unlocks the genes so that they can be expressed.	activator protein	What analogy is used to explain activator protein?
Electric circuit is often compared to a plumbing system. Just as water flows through pipes, electricity flows through wires. The voltage in the electric circuit is like the water pressure, and the current is like the flow of water.	electric circuit	What analogy is used to explain electric circuit?
An electric circuit can be thought of as a closed loop formed by a conductor (usually copper wire). Current flows through the conductor in one direction and returns to the starting point. The current is like a river flowing through the wire, and the battery or power source is like the sun providing energy to allow the water to flow.	electric circuit	What analogy is used to explain electric circuit?
Electricity flows like water in a river. Just as the height of a river can create different amounts of pressure on its banks, the voltage in an electric circuit creates a kind of pressure that pushes electricity through the wires.	electric circuit	What analogy is used to explain electric circuit?
An electric circuit can be thought of as a hosepipe. If you turn on the tap (switch), water flows through the pipe. If you put your thumb over the end of the pipe (closed switch), no water will flow.	electric circuit	What analogy is used to explain electric circuit?
Electricity is flowing through a wire in the same way that water can flow through a hose. Just as you can turn the faucet off to stop the water, you can also turn off an electric circuit to stop the electricity.	electric circuit	What analogy is used to explain electric circuit?
The hydrophobic effect is often compared to the way oil and water mix. Oil and water do not mix because the oils are hydrophobic and the water is hydrophilic. The molecules in oil are attracted to each other more than they are attracted to the molecules in water. This causes the oil to group together, forming droplets that float on top of the water.	hydrophobic effect	What analogy is used to explain hydrophobic effect?
The hydrophobic effect is often described using the analogy of two pieces of ice in a glass of water. The ice will float to the top because it is less dense than the water. This happens because the atoms in the ice are arranged in such a way that they are more spaced out than the atoms in liquid water. This means that there is more space between each atom in an ice crystal than there is between each atom in liquid water. Since these spaces are filled with air, this makes the ice less dense than liquid water and it floats to the top.	hydrophobic effect	What analogy is used to explain hydrophobic effect?
The hydrophobic effect is often compared to the way oil and water mix. Oil and water are both liquids, but they do not mix together. This is because oil is hydrophobic (it does not like water) and water is hydrophilic (it likes water).	hydrophobic effect	What analogy is used to explain hydrophobic effect?
Water molecules are constantly in motion, and they naturally move to contact other water molecules. This is why water beads up on a freshly waxed car. The wax forms a barrier between the water and the car, preventing the water from contacting the metal surface. Hydrophobic substances work in a similar way, but on a much smaller scale. The hydrophobic effect is what causes oil and gas to form droplets when spilled on water because the hydrocarbons are repelled by the water molecule	hydrophobic effect	What analogy is used to explain hydrophobic effect?
Water molecules are attracted to each other by hydrogen bonding. This attraction causes water droplets to form and keeps them together. The hydrophobic effect is the opposite force that attracts nonpolar molecules to each other.	hydrophobic effect	What analogy is used to explain hydrophobic effect?
The analogy of a telephone is used to explain signal transduction. A caller speaks into the phone, and their voice is transmitted as an electrical signal along the wires. The signal is then converted back into sound by the receiver. In a similar way, hormones are released by cells and travel through the bloodstream to other cells. The hormone receptors on these target cells convert the hormone back into an electrical signal, which initiates a response in the cell.	biological signal transduction	What analogy is used to explain biological signal transduction?
One analogy used to explain signal transduction is that of a telephone. The phone receives an incoming call and the sound waves from the caller's mouth are converted into electrical signals by the microphone. These signals pass through wires to the phone's receiver, where they are turned back into sound waves that we can hear. In a similar way, proteins in our cells receive chemical messages (signals) from other cells and convert them into electrical signals. These signals then activate or deactivate other proteins, which causes changes in the cell	biological signal transduction	What analogy is used to explain biological signal transduction?
The analogy of a telephone is often used to explain the process of signal transduction. The phone receiver converts sound waves into electrical signals that can be heard by the listener. In the same way, receptor proteins on the surface of cells convert external stimuli (such as hormones or neurotransmitters) into biochemical signals that can influence cellular function.	biological signal transduction	What analogy is used to explain biological signal transduction?
A lock and key analogy is often used to explain how a receptor on the surface of a cell can bind with a specific molecule. The receptor is like the lock, while the molecule that binds to it is like the key.	biological signal transduction	What analogy is used to explain biological signal transduction?
The analogy of a telephone is often used to explain how biological signal transduction works. A person's voice is converted into an electrical signal by the microphone, which sends it down the phone line. The electrical current then travels through the wires and transformer in the telephone box until it reaches your ear. In a similar way, proteins within a cell convert chemical signals into electrical impulses, which are then sent across the cell membrane to other proteins.	biological signal transduction	What analogy is used to explain biological signal transduction?
