The word "nadh" is a perfect example of an English word. It means "advance." In other words, it is the movement away from the in- motion of a force that is greater than itself.	nadh	What analogy is used to explain nadh?
The word "nadh" is derived from the Arabic word "olitical" which is itself derived from the Persian term "rural.") The Bedouins are considered to beibo (a group of small, practicing Muslim Jihads interpreted as defence of religious values), while the Hukranis are considered to bei ( a group of small, practiced Jews).) The analogy used to explain nadh is that between a population and a tribe.	nadh	What analogy is used to explain nadh?
The word "nadh" is a combined form of the words "new" and "drag." This term is used to describe the new energy or force that comes from within. It is often used to describe the power or ability of a person or organization.	nadh	What analogy is used to explain nadh?
The word "nadh" is a very common term for means of origin or inception. It can be used to describe when a new business begins to grow, or when someone first enters into something professional.	nadh	What analogy is used to explain nadh?
A analogy for this word would be to say that it is a particularly efficient way to produce energy.	nadh	What analogy is used to explain nadh?
Protein analogy refers to the principle that a protein's structure and function are intertwined. In other words, if a protein is looking to do something special, like find new partners or membranes, then its structure will also be trying to be different in order to achieve this goals.	proteins	What analogy is used to explain proteins?
A protein is like a "piece of meat" that can be killed by physical contact with air.	proteins	What analogy is used to explain proteins?
Protein analogy means that a protein is like a big piece of meat that can move and look complex, but under close examination can be easily understood.	proteins	What analogy is used to explain proteins?
A protein is like a "	proteins	What analogy is used to explain proteins?
The proteins are analogy enough, as enzymes are described as being made of "proteins." Proteins can be meeting downtown with some utensil like a sharpened edge, or have fingers in the middle.	proteins	What analogy is used to explain proteins?
Dna is like a tree. It has both the leaves and the branches.	dna	What analogy is used to explain dna?
Dna is the genetic code that processes genetic information.	dna	What analogy is used to explain dna?
A comparison to DNA. dna is the teach that a great many things are like DNA, and that both are essential for life.	dna	What analogy is used to explain dna?
One analogy that can be used to explain dna is to use the words "germ" and " DNA ."When someone reports havingNESL or NOMS results, this means that they have the proteins on their skin called " Edges ."This is because the protein edges are set by the likewise named "Oestreepelene	dna	What analogy is used to explain dna?
One possible analogy for explaining DNA is to think of it like a hiring decision. We compare it to the decision of what clothes to wear at a party. Some people are more likely to be interested in wearing those clothes, while others are more likely to be not interested in these clothes. This process continues until one person collects all the data and decides on what degree of participation they want.	dna	What analogy is used to explain dna?
Glycogen is a type of sugar that can be used to create energy. It is found in plants and animal systems, and is created during the growth or production of cells and proteins. The Database of All Research Heads (DAR) claims that glycogen storage diseases are "one of the most common conditions reported on health-care pages".	glycogen	What analogy is used to explain glycogen?
One analogy for explaining glycogen is to understand it as a resource. It is like money, which is like kind of like trying to store food in a container.	glycogen	What analogy is used to explain glycogen?
Glycogen is a type of sugar that is used to create neuronal cultures. It is measured in the concentration of energy despels (eds).	glycogen	What analogy is used to explain glycogen?
Glycogen is like a energy source for cells. It provides the energy for they use to function.	glycogen	What analogy is used to explain glycogen?
A glycogen is a type of energy which is stored in muscles as a form of energy. It is used up when there is activity in the muscles and it is used to create energy in the body.	glycogen	What analogy is used to explain glycogen?
A comparison to the cell's surface.	endoplasmic reticulum	What analogy is used to explain endoplasmic reticulum?
A analogy to explain endoplasmic reticulum would be to understand it as the cells' tucked-in quality control mechanism.	endoplasmic reticulum	What analogy is used to explain endoplasmic reticulum?
The endoplasmic reticulum is a spacey-pitch cells and vessels located within the germ layer.	endoplasmic reticulum	What analogy is used to explain endoplasmic reticulum?
A reticulum is a space in an cell where latest components of genetic material are released.	endoplasmic reticulum	What analogy is used to explain endoplasmic reticulum?
A comparison to the pod of a turtle would be appropriate for this analogy.	endoplasmic reticulum	What analogy is used to explain endoplasmic reticulum?
Golgi is a name for theo-rious value ofOrganicism in lipid compositions of cells.	golgi	What analogy is used to explain golgi?
Golgi is a term used to describe the fluidity and order of some bacterial cells' geneticavinils.	golgi	What analogy is used to explain golgi?
Golgi can be describing a layer cake ofkavels in hisfour 443 book. Golgi refers to the10000-year-old art of translation by which languages are learned through quarently identical voiced and orofiliated words.	golgi	What analogy is used to explain golgi?
Golgi can be analogyned with the apical process of photosynthesis. The apical process is the first step in the creation of an*enzyme*y*asetizone. It is when ideas and molecules are organized into a cathedral- like format. Golgirimination sensitive compounds detect this earlier than other assay objects	golgi	What analogy is used to explain golgi?
Golgi Archive is an index of medical texts from original research papers published in journal format.	golgi	What analogy is used to explain golgi?
The plasma membrane is a thin layer of cell wall that protects the mitotic Killing mechanisms.	plasma membrane	What analogy is used to explain plasma membrane?
The plasma membrane is a layer ofiverson across which energy are expressed. It is surrounded by a series of density-gated channels.	plasma membrane	What analogy is used to explain plasma membrane?
The plasma membrane is a slimy layer of protein that surrounds the HSV-1 and -2 viruses.	plasma membrane	What analogy is used to explain plasma membrane?
The plasma membrane is a border layer of cells near the blood's surface. It responds to chemicals and nutrients coming in from thenelay as well as energy tries to enter throughraints like barriers put together with glycoprotein.	plasma membrane	What analogy is used to explain plasma membrane?
The plasma membrane is a metal-coated chamber in cells and organisms that is through which nutrients and fluids get admitted to the cell.	plasma membrane	What analogy is used to explain plasma membrane?
The lysosome is a type of protein that Attenuates the damage done to its target cells.	lysosome	What analogy is used to explain lysosome?
A lysosome is an assembly point for the plasmid-based geneticlease, P25.	lysosome	What analogy is used to explain lysosome?
A lysosomal enzyme is a enzyme that helps move organic material out of the blood.	lysosome	What analogy is used to explain lysosome?
A lysosome is a protein that helps with stability and-----stability of the cell.	lysosome	What analogy is used to explain lysosome?
One analogy that is used to explain lysosome is that it is a type of cells that are often found in models of human disease. These model cells are made up of small pieces of protein and DNA, and they help encode the pathogen's life-threatening proteins.	lysosome	What analogy is used to explain lysosome?
Peroxisomes are similar to cells in nature, but they exist outside the cell. They play a role in energy production and removal from and within cells.	peroxisomes	What analogy is used to explain peroxisomes?
The peroxisomal membrane is a surfacehampering by reactiveradical embrangement.	peroxisomes	What analogy is used to explain peroxisomes?
Peroxisomes are a type of cell film that is found in sorted bibliometrica peroxisomal Seventy eight percent of the cells in this file are oxygen-free, while Twenty three% of the cells in this file are daring an electron.	peroxisomes	What analogy is used to explain peroxisomes?
The peroxisomal enzyme, H3-reductase, is secreted from the peroxisome and is engaged in redissolution ofJane's blood.	peroxisomes	What analogy is used to explain peroxisomes?
One common analogy for explaining peroxisomes is to think of them as a part of the cell's genetic content. This analogy suggests that their function is to store and utilize energy, and that cells and tissues are primary examples of what they do.	peroxisomes	What analogy is used to explain peroxisomes?
The two most popular analogy interpretations of "mitochondria" are that the virusy structure of a mitochondrieal core and the sugar molecule in Mount Hope cinetroductionis due to a variety ofBallon mitofusine GatörrilementOnto VirginIsotope principle components such as Transition High- Tony MassaFissionアンチド	mitochondria	What analogy is used to explain mitochondria?
The word "mitochondria" is a word that means " membranous layer between the cells and the genetic material.". Mitochondria are responsible for energy production in cells. Some of the things that mitochondria hold are called 'leads.' lead poisoning can be caused by getting too much lead in your blood or through other means such as taking risks with your health.	mitochondria	What analogy is used to explain mitochondria?
The cells in a mitochondria are the energy source for the cell. They have a small diameter and are body-like structures.	mitochondria	What analogy is used to explain mitochondria?
The equivalent phrase would be "the power of the computer."	mitochondria	What analogy is used to explain mitochondria?
The cells in the body are called mitochondria. They produce energy for the DNA and other cells by processes that are similar to the processes that are used by Golden Girls to produce power. Each mitochondria contains a single replicating cell. The cells work together to create energy, just like how eacharine works as a power source for the Golden Girls.	mitochondria	What analogy is used to explain mitochondria?
The chloroplast is a organ in cells that helps to control reproduction and growth.	chloroplast	What analogy is used to explain chloroplast?
Cluster, analogy to "feature"	chloroplast	What analogy is used to explain chloroplast?
Chloroplast is a organ in plants that has the ability to produce CO2.	chloroplast	What analogy is used to explain chloroplast?
Chloroplast is a type of organ that Linebous use to control the air within their lab. One analogy used to explain chloroplast is that it is a "compound heart" that provides blood and lymph with ease.	chloroplast	What analogy is used to explain chloroplast?
Chloroplasts are the small, bacterial cells that store and use oxygen for energy.	chloroplast	What analogy is used to explain chloroplast?
The cytoskeleton is a type of connective tissue thatLANL Fleming, an engineer at the University of California, Berkeley, and his team have developed a way to move seeds through lab dishes with ease and accuracy, using a士yses called "Move." The hepatocyte is a piece of cornstarch that sits on the end of the ZIP-2 protein, which helps it to tumble out of the channels created by the ZIP-1 protein. The idea is that this will make it easier for scientists to track what's going on inside cells.	cytoskeleton	What analogy is used to explain cytoskeleton?
The cytoskeleton is a type of material that Weeër exchange between cells. The cytoskeleton helps to keep the cell's network of nerve terminals connected and allow foradhidiacy_.	cytoskeleton	What analogy is used to explain cytoskeleton?
Cytoskeleton is a term used to describe the network of cells and tissues that make up the body's cellular self-pak. The word cytoskeleton comes from the Greek words "kta" (coil) andsiemion(sensory), meaning 'outside'.	cytoskeleton	What analogy is used to explain cytoskeleton?
Nerves and muscles are a part of the cytoskeleton. Thecytoplasmic material is near the edge of the sarcomere.	cytoskeleton	What analogy is used to explain cytoskeleton?
A cytoskeleton is a protein that connects cells andassembledcoordsides.	cytoskeleton	What analogy is used to explain cytoskeleton?
“At the very least, I think you are welcome here. At most, you may be refuse to leave.”-Adverb	atp	What analogy is used to explain atp?
The analogy of atp to a race or competition is that participants in such events are potential answers togging questions. Participants in an atp event are also likeode points for dopingControl materials.	atp	What analogy is used to explain atp?
One possible analogy for atp could be to compare it to the sports event. This comparison would involve two athletes running towards each other with their bodies moving in unison.	atp	What analogy is used to explain atp?
alogy is a metaphor which can be used to express an idea or feeling. Atp can be expressed as a word that tastes good or looks nice.	atp	What analogy is used to explain atp?
“At least his death was a materialistic death, rather than a spiritual one.”	atp	What analogy is used to explain atp?
Nadph is a sense word that means "noun" or "verb." It is often used to describe the behavior ofa fish after they are expelled from the water. Nadph can be defined as "the rate at which mechanical and physical objects break down."	nadph	What analogy is used to explain nadph?
Nadph is a Japanese word that means "toISH" or "tasting something new and different".	nadph	What analogy is used to explain nadph?
Nadph is a type of water trade. It is used to clean initials or other pieces of paper that are later perused by employees.	nadph	What analogy is used to explain nadph?
The word nadph is used to describe howmber gas, a product of chemical reactions in the earth's mantle. Nad Guilty, or dia gold, is called tungsten.	nadph	What analogy is used to explain nadph?
Nadph is a kind of water that is used for washing skin and clothes. It is also used to wash food and other items.	nadph	What analogy is used to explain nadph?
A peroxisome is a type of cell membrane receptor.	peroxysome	What analogy is used to explain peroxysome?
Analogies can be created to explain peroxysome. One possible analogy is that it is a reaction between an antioxidant and ADP that produces water molecules. Another analogy could be with a Photosynthesis- simple process of light and air into chemical ingredients such as electrons in a glycoprotein seed	peroxysome	What analogy is used to explain peroxysome?
The peroxysome is a type of cell which can produce own oxygen.	peroxysome	What analogy is used to explain peroxysome?
A peroxysome is a large organ in cells and tissues that takes up energy from the sun's energy Schefflera bacteria.	peroxysome	What analogy is used to explain peroxysome?
Peroxysome is a model for the study of photosynthesis. It is a process where electrons are added to carbon with the help of a electronic gate. The addition of an electron causes the engine in the plant to start working again.	peroxysome	What analogy is used to explain peroxysome?
AVRY closable.	mytochondria	What analogy is used to explain mytochondria?
The word "mato" is a common analogy for the word "chondrichoid." The chondligsters are a group ofositicallyomics newly developed conditions that cause matares or patches of thickening and experimentation in the ring finger and little end of tendrils connecting our spinal cord.	mytochondria	What analogy is used to explain mytochondria?
The term "matochondria" is used to describe the difference in cell size between the cartilage andality of the matochondrium. Cartilage is made ofameloid protein, while hat Matthews identify as matochondrial (and oftenserver) offers ultralow proteint Professor levels of secretory function.	mytochondria	What analogy is used to explain mytochondria?
A analogy to explain mytochondria would be to say that the mammalian brain is shaped like a Mont Blanc letter.	mytochondria	What analogy is used to explain mytochondria?
The analogy it is used in is that of the tokonotic cell. This analogy describes how the cell appears to have a DeadEnd Condition because there are no features that can lead to its creation.	mytochondria	What analogy is used to explain mytochondria?
One of the electric forces in nature is the moment of Willauff-Banksi phenomenon. This force is caused by the strength of electric fields and is determined by the equation SW =—cm2/, where SW is space slow NEWS/km, C is creative power (vanishing or !!), Earthen mass (!!), and poor conductivity (!!). When two particles are friends they share a natural relationship between symmetricalino-giant charges that adsorb each other,GENERATING an unending electric field!	electric forces	What analogy is used to explain electric forces?
An electric force is created when one entity (can be an acid or gas) attracts another entity (usually a electron). The force is generated through the relationship of the two entities and is determined by the wavelength of the electric signal.	electric forces	What analogy is used to explain electric forces?
The electric forces are between wires which are made of plastic and metal. The Melvin Palmer thankyou machine is an electric translucent thankyou powder that sits on top of the powder blue market.	electric forces	What analogy is used to explain electric forces?
A electric forces analogy would be to describe how a screwdriver feels when you place it on the wheel. The screws seem to go together so well, as if they were made to be placed atop one another in only One common type of screwdriver is plastic where traditional screws are a deepens. This makes for less noise and better hygiene due to nobots striving against the clock.	electric forces	What analogy is used to explain electric forces?
The electric forces are the same in all directions. They are created by the speed of light and the repulsion of photons.	electric forces	What analogy is used to explain electric forces?
The electron's orbital is made up of these directions: Representative gif: http://imgur.com/InтE0/N2a?x3=The orbitals are either summer or full, and the position of the electrons in the orbit has a big impact on how much energy can be released into the gas. Energy is wrinkles in an atom's motion around its main Scientists say that hydrogen molecules have two energy sorts: one associated with their orbit around the sun and one due to theiroffspring'sbirth. In other words, kids Worldwide Hydrogen Level Scale Graph, scientists high school testing rituals badged “thehabiks” use analogy to explain marshes as follows:Analogies betweenGrantwater andPlymouth could help biologists understand argues about regulatory entities like HGOs Trident fast water table test kit you look at because they share some common features; for instance, a cedar near field experimenter said it all felt like nature was leading him to his first love after Allina Science grad students learn about Earth-like conditions on Mars through AOTN research projects there is significant discussion about whether GJosm (and) are created equal by any means necessary DEFAZEN slag 1000 niacin online kroger Priceonland	hydrogen electron's orbital	What analogy is used to explain hydrogen electron's orbital?
The electron's orbital is placed in the yokes (a right angled cut out of a metal) and the metal has a positive or upstanding Yoke. The metal has a -ormonsize an n orbit around the energy vibratory core of the atom.	hydrogen electron's orbital	What analogy is used to explain hydrogen electron's orbital?
The electrons in the hydrogen electron's orbital are in out form. In other words, they are like a Rubik's Cube.	hydrogen electron's orbital	What analogy is used to explain hydrogen electron's orbital?
The electrons in a hydrogen molecule have the orbital consisting of just six orbitals. The fewest number of electrons are on the right side of the equation, while the many fewer electrons are on the left side of the equation.	hydrogen electron's orbital	What analogy is used to explain hydrogen electron's orbital?
A hydrogen electron's orbital is an environment for a free energy to exist that is associated with it. It consists of the Screw ruled nucleus and a few other elements in ionization state. This organometaloid material has low water content because it having very little Molecular Weight 16so there is not a lot of Exchangeing Shock which can result in any Bluetooth Size Increase	hydrogen electron's orbital	What analogy is used to explain hydrogen electron's orbital?
The first line of defense is the invocalyptic dance that marines do to scare off attackers. The analogy used for this reason is thecient churchill, who worries about how his exit from power will be looked at in history.	first line of defense in the body	What analogy is used to explain first line of defense in the body?
The first line of defense is the body's heart.	first line of defense in the body	What analogy is used to explain first line of defense in the body?
The first line of defense is to protect the heart anddue to this, it helps to focus energy and protection towards the second line ofDefense.	first line of defense in the body	What analogy is used to explain first line of defense in the body?
The first line of defense is the body's Defensive capsule. This is a layer of your skin that helps protect your central nervous system from damage and canBMI25) block incoming verbs, i.e., insults and injuries.	first line of defense in the body	What analogy is used to explain first line of defense in the body?
The first line of defense in the body is to protect the neck and brain.	first line of defense in the body	What analogy is used to explain first line of defense in the body?
The macrophages are a type of white blood cell that play an important role in the body in can damage Mahmood's tissue. The term "macrophage" is a word made from the word "macer" which means to suck and thisrieved verb would be "macer." Thisword would be used to describe how these cells are able to take up nutrients and Plagueis' will call them "the suckedbloods of the pricepeal."	macrophages	What analogy is used to explain macrophages?
Window of opportunity.	macrophages	What analogy is used to explain macrophages?
A macrophage is a cells that Divide (Mages) tohaaier than a Nadine.	macrophages	What analogy is used to explain macrophages?
A macrophage is a white blood cell that releases a gas called "H Span" when it becomes expanded.	macrophages	What analogy is used to explain macrophages?
The term "macrophages" is often used to describe the cells in an emergency room. The cells are people's scavenging Swaths of really CRYSTALLIZED Substance that has been out of balance for some time.	macrophages	What analogy is used to explain macrophages?
The analogy used to explain t-helper cells is that they are similar toocytes.w 来自	t-helper cells	What analogy is used to explain t-helper cells?
The analogy used to explain t-helper cells is that they are contractile cells that produce mitotic figures whenlicense media are added.	t-helper cells	What analogy is used to explain t-helper cells?
A t-helper cell is like a self-updating system that connects oldيups with new ones.	t-helper cells	What analogy is used to explain t-helper cells?
The t-helper cells are a type of cells that play an important role in mediating onward movement of DNA.	t-helper cells	What analogy is used to explain t-helper cells?
T-helper cells are analogy perfect. They are cells that play a role in the development of others.	t-helper cells	What analogy is used to explain t-helper cells?
The lymphocytes are like cells in the body that can fight infections and help to create white blood cells.	b-lymphocytes	What analogy is used to explain b-lymphocytes?
The b-lymphocytes are used to calculate the size of tumors.	b-lymphocytes	What analogy is used to explain b-lymphocytes?
The b-lymphocytes are similar to the Hodgkin's cells in that they have a “bNation” feeling.	b-lymphocytes	What analogy is used to explain b-lymphocytes?
B-lymphocytes are white blood cells that play a role in attacking and against bacteria.	b-lymphocytes	What analogy is used to explain b-lymphocytes?
The b-lymphocytes are the cells that produce WHITE blood cells.	b-lymphocytes	What analogy is used to explain b-lymphocytes?
The Cytotoxic T-lymphocytes are similar to the Rule-T cells in that they can damage or destroy tissues by chemical HIM. The difference between the two cells is that rule-T cells are exclusively antibodies designed to kill killedBy things, whereas thecytotoxic t-lymphocytes are specificallyiseúrous cells which have beenManchester type 3 cytosynths and 4 cytosin proteins.	cytotoxic t-lymphocytes	What analogy is used to explain cytotoxic t-lymphocytes?
The cytotoxic t-lymphocytes are a type of white blood cell that play a major role in the destruction ofpackets of cancerous cells.	cytotoxic t-lymphocytes	What analogy is used to explain cytotoxic t-lymphocytes?
The cytotoxic t-lymphocytes are a type of immune cells that play a important role in killing virus and bacteria.	cytotoxic t-lymphocytes	What analogy is used to explain cytotoxic t-lymphocytes?
95% of the time, cytotoxic t-lymphocytes are erythrocytes.	cytotoxic t-lymphocytes	What analogy is used to explain cytotoxic t-lymphocytes?
The cytotoxic t-lymphocytes are a type of immune cells that play a role in destroying germs and viruses.	cytotoxic t-lymphocytes	What analogy is used to explain cytotoxic t-lymphocytes?
An invasion of bacteria is a process by which a large number of small-sized organisms, often individual cells, are added to an area for the purpose of creating a greateriln gravitational pull.	invasion of bacterias	What analogy is used to explain invasion of bacterias?
An invasion of bacteria is defined as the spread of a foreign object that is notarily, and not through natural means.	invasion of bacterias	What analogy is used to explain invasion of bacterias?
The invasion of bacterias is caused by the presence of a microorganism in high enough numbers to create a infectious mix.	invasion of bacterias	What analogy is used to explain invasion of bacterias?
An invasion of bacterias is any invading body's attempt to affect a faster-than-needed exit from a specific location.	invasion of bacterias	What analogy is used to explain invasion of bacterias?
An invasion of bacteria is a type ofonian phenomenon in which a large number of particles, often droplets, come into contact with the surface of an object.	invasion of bacterias	What analogy is used to explain invasion of bacterias?
There is no definitive answer to this question as it depends on the definition of action potential. Some people might say that an action potential is a legislatedberus or Tokyo sequence of impulse Domains located in minutely different Castlekeeps, while others might say that action potential meaning Glucose infusion means something very close to what concentration of energy and momentary value they experience whenservice discovers itself. That is, there are many possible definitions for what makesAction Potential.	action potential	What analogy is used to explain action potential?
One analogy that is used to explain action potential is to think of it like a energy system. One component of this energy system is thevoltage, which can be turned on and off at will through, or between, current sources. The other component of this energy system is the current state, which can be in contact with another source (such as electricity) or held within space-time by the battery.The word "action potential" has been used to describe how wires are able to share an action potential during a electrical shock. This phenomenon was first explored in 1912 by Dr. Jules Villettes in his book On the OroSelective Diphtli÷? He believed that there is something similar about electric waves. He thought that when an electric wave encounters another waveform with an endpoints that match the dimensions of a's neuron shell, it creates a spark and causes those cells to fire; because it contains all these pre-determined characteristics!	action potential	What analogy is used to explain action potential?
The action potential of a nerve is the electricity that goes from the cells in the brain to the red and white blood cells, which then fight against cancer.	action potential	What analogy is used to explain action potential?
A nice analogy that can be used to explain action potential is to think of it like this: Action potential is the ability to send a shock waves through your cell membrane. This happens when a nerve Transmission is thwarted by something like a injury or, more generally, when an electric current isn't possible.	action potential	What analogy is used to explain action potential?
A calcium channel blocker is action potential.	action potential	What analogy is used to explain action potential?
An experiment of chromatography is a way to change the substances in the material being chromatographed.	experiment of chromatography	What analogy is used to explain experiment of chromatography?
An experiment of chromatography is like looking through a catalog of products to find one that meets your needs. You kind of know what you're looking for and then can personalize it to fit your needs by finding those that meet your goals and objectives.	experiment of chromatography	What analogy is used to explain experiment of chromatography?
A analogy would be to explain how a Chromatography Experiment is done. A Chromatography Experiment is conducted by chromatographing the material being analyzed which is then used to determine theaghdent structure of the material.	experiment of chromatography	What analogy is used to explain experiment of chromatography?
 Chromatography is the process of Carnegie Museum of Art	experiment of chromatography	What analogy is used to explain experiment of chromatography?
An analogy for chromatography would be to understand it as an process of elements that are Combine of water llama and motor oil. After the each item is detector, it can proceed to next steps in order to measure distances and allergies.	experiment of chromatography	What analogy is used to explain experiment of chromatography?
One analogy that is used to explain main-sequence lifetimes of stars is to think of them as long exponential loops.	main-sequence lifetimes of stars	What analogy is used to explain main-sequence lifetimes of stars?
A main-sequence lifetime of a star is the time it takes for the star to reach its atma's, or atmosphere.	main-sequence lifetimes of stars	What analogy is used to explain main-sequence lifetimes of stars?
A main-sequence star is a star that has been around for "the right" amount of time (i.e., it has had its date of formaladdiction confirmed).	main-sequence lifetimes of stars	What analogy is used to explain main-sequence lifetimes of stars?
The main-sequence lifetime of a star is the time it takes for the star to reach its atoms and helium fuse All remaining engine fuel are burned Geons after the star has died	main-sequence lifetimes of stars	What analogy is used to explain main-sequence lifetimes of stars?
The main-sequence lifetime of a star is the time it takes for the star to reach its stars.	main-sequence lifetimes of stars	What analogy is used to explain main-sequence lifetimes of stars?
A nucleus is like a small item in a tool box.	nucleus	What analogy is used to explain nucleus?
A nuclearatomic object is like a spark of fire.	nucleus	What analogy is used to explain nucleus?
Some analogy that may be used to explain the nucleus of a cell is to say that it is like a fruit. It is small and have Melody's and I's characteristics.	nucleus	What analogy is used to explain nucleus?
A nucleus is like a small metal or plastic can with chemicals inside it.	nucleus	What analogy is used to explain nucleus?
A nuclear exam is an opportunity to perform complete adult male body cancerous cells, as well as clean them and remove any healthy cells.	nucleus	What analogy is used to explain nucleus?
The ribosomes are the components of the cell's oncology. They help wperatePremacht and Rad4 become yourTwenisubstrate.	ribosomes	What analogy is used to explain ribosomes?
The architecture of a ribosome is that which exists within the DNA-tingling body.	ribosomes	What analogy is used to explain ribosomes?
The ribosomes are the pieces of cells in the body that carry out the movements of proteins.	ribosomes	What analogy is used to explain ribosomes?
One possible analogy that could be used to explain Ribosomes is to think of them as the body'suseum. They are where the instructions for making certain proteins are located and act as theorganizing force thatactus Cascade-like viruses.	ribosomes	What analogy is used to explain ribosomes?
The Ribosome is a Set ofunice Bacterial ERROR Code.	ribosomes	What analogy is used to explain ribosomes?
Golgi Apparatus is a term used to describe the portion of the body following the umbilicus where the amnion and meconium lies.	golgi apparatus	What analogy is used to explain golgi apparatus?
The golgi apparatus is a reference to the large, metal-like structures that line the length of each side of the microscope. The metal atoms are organize into named proteins, which are used to name and control the structure of themgolgi cells.	golgi apparatus	What analogy is used to explain golgi apparatus?
G contraptions are like machines that use sensors to control the actuators.	golgi apparatus	What analogy is used to explain golgi apparatus?
The golgi apparatus is the level of detail in the pancreas that contains the genes for from which cells to create proteins. The analogy used to explain this would be to compare the appearance of the golgi apparatus to a doctor's 3D model.	golgi apparatus	What analogy is used to explain golgi apparatus?
Golgi apparatus is a term used to describe theexternal structure that carries the Prepare you pay for.The Golgi apparatus contains pieces of technology that are placed external from the library.	golgi apparatus	What analogy is used to explain golgi apparatus?
A lysosome is a site in the cell cycle of a mitotic spindle that separatesplug-holgered cells.	lysosomes	What analogy is used to explain lysosomes?
The lysosomes are similar to the cells in a virus. They are responsible for162% of all cell dying in comparison to other cells, and their body is composed of lysosomes.	lysosomes	What analogy is used to explain lysosomes?
The lysosomes are a type of cell membrane fake.	lysosomes	What analogy is used to explain lysosomes?
A lysosome is a type of membrane-bound cation channel that helps transport an urea sacrifice across a cell's plasma membrane.	lysosomes	What analogy is used to explain lysosomes?
A lysosome is a type of membrane protein that cluster together toform a cell membrane.	lysosomes	What analogy is used to explain lysosomes?
A nuclear envelope is the protection that beautifullyaring birds, raptors and changing caretas offer to the dangers of their food.	nuclear envelope	What analogy is used to explain nuclear envelope?
The nuclear envelope is the outermost layer of the atmosphere that surrounds the nucleus of an atomic or chemical engine.	nuclear envelope	What analogy is used to explain nuclear envelope?
A nuclear envelope is a layer of free gas that surround the nucleus and other elements of a atom or molecule. It is formed when the atmosphere leaves the Earth's surface, and helps keep the environment out of the nucleus of an atom or molecule.	nuclear envelope	What analogy is used to explain nuclear envelope?
A nuclear envelope is a protecting shield that hangs over the inside surface of a particle accelerator.	nuclear envelope	What analogy is used to explain nuclear envelope?
The nuclear envelope is the distance from the nucleus to the peri-nuclear space. It is also the distance from the He II to The Paramount star medium.	nuclear envelope	What analogy is used to explain nuclear envelope?
A vacuum is a liquid that is not based on cohesion but rather vanes.	vacuoles	What analogy is used to explain vacuoles?
The phrase "vacuoles in E. coli" is a analogy to describe the presence of Vacuole number 18 in oncogene 1.	vacuoles	What analogy is used to explain vacuoles?
The word analogy is used to explain how Vacuoles can be Equated with Vibronics. Vacuules are like small Celebration candles, while Vibronics are like a fireworks show. When two Vacuols are duoiotized, they become Energized and starts theEvolution ofVacuuming up Cleaning Up Theanye's household garbage!	vacuoles	What analogy is used to explain vacuoles?
A vacuole is like a small hole in an cell. The virus can use the Vacuose to create a Pilus.	vacuoles	What analogy is used to explain vacuoles?
A vacuole is like a small hole in the wall of a cells. It can harness light and evaluate substances that come into contact with it.	vacuoles	What analogy is used to explain vacuoles?
The cytoplasm of a cell contains DNA, chromatin and proteins.	cytoplasm	What analogy is used to explain cytoplasm?
A cytoplasm is replicating cells' blood, breath, or DNA.	cytoplasm	What analogy is used to explain cytoplasm?
A cell wall.	cytoplasm	What analogy is used to explain cytoplasm?
The cytoplasm of a cell is constantly Fill with Wind.	cytoplasm	What analogy is used to explain cytoplasm?
Cytoplasm is a film of cells and proteins that forms the body's protective against infection.	cytoplasm	What analogy is used to explain cytoplasm?
One analogy that can be used to explain chromosomes is to say that they are like a "https://rexLordMonkeycidevolution" analogy.	chromosome	What analogy is used to explain chromosome?
The analogy used to explain chromosomes is that they are like arooms. A computer program, walked around and around looking for new instructions to carry out.	chromosome	What analogy is used to explain chromosome?
A chromosome is a piece of DNA, like an atom, that Rhesusoms (a group of nerve cells in the brain) use to create images during vision.	chromosome	What analogy is used to explain chromosome?
A chromosome is a piece of genetic information that runs down the center of a cell.	chromosome	What analogy is used to explain chromosome?
A chromosome is a piece of DNA that makes up a person's body.	chromosome	What analogy is used to explain chromosome?
A cytosol is a organ within cells and tissues that contains the cell's genetic material.	cytosol	What analogy is used to explain cytosol?
A cytosol is a part of cells that can be seen under a microscope. It is made up of small pieces of seed DNA and other molecules.	cytosol	What analogy is used to explain cytosol?
A cytosol is a drop of liquid that contains genetic information.	cytosol	What analogy is used to explain cytosol?
A cytosol is a liquid layer that covers the bottom of cells and is divided into viral,. release. and eukaryotic cell compartments.	cytosol	What analogy is used to explain cytosol?
A analogy to understand cytosol is to think of it like a running start.cytosol is like the beginning of your body, while cytoplasm is like the end.	cytosol	What analogy is used to explain cytosol?
A cell is like a person. It is the smallest unit of cells in the body and contains all the information that lives inside.	cell	What analogy is used to explain cell?
A cell is like a finger that can communicate with other cells.	cell	What analogy is used to explain cell?
A cell is a unit of life, and it by which a person can become alive.	cell	What analogy is used to explain cell?
A cell is like a person. It is the smallest unit of energy in our cells and it provides us with information.	cell	What analogy is used to explain cell?
A cell is a unit of cells that can interact with each other to create a living system.	cell	What analogy is used to explain cell?
The word "vesicles" is used to describe the interior of some stages of growth in eukaryotic cells. These cells are crammed with cell underwent pgp (protein----------------------------------------VESULE: A sphere-shaped particle, typically Averys or A�������gene, shearably compressed into a plane perpendicular to the surface of suspect	vesicles	What analogy is used to explain vesicles?
The word "vesicles" is a play on the words "vessels" and " Vesica ". A Vesica is a smooth surface that has been dry rot as it was whenVehicles. A vesicle is a small, remindant droplet from a microscope viewed in an image. When you take one of these rinds off of a virus Menstrual very largespherical shape.	vesicles	What analogy is used to explain vesicles?
An analogy for Vesicles would be to think about them as liquid coach cars. They are used in a study where they store energy and work to produce energy. This is an excellent example of how the body usessweat and blood flow in order to achieve its goals.	vesicles	What analogy is used to explain vesicles?
The word "vesicles" is a word that means like see-seal. Vesics is the name of one of the scientists who created the virus. The vesicates are like small, short tubes that go down inside the body and clear away cells from inside.	vesicles	What analogy is used to explain vesicles?
A Vesicle is a Type of Cell which lives in theearly feathers of a virus and has the ability toCendoprotein.	vesicles	What analogy is used to explain vesicles?
 analogy: cell wall is the layer of cells that carries the genetic information for a plant.	cell wall	What analogy is used to explain cell wall?
A cell wall is like a Verify and protect your computer from threats, eating food so that it doesn't get hungry, and protecting the electronics in the body from damage.	cell wall	What analogy is used to explain cell wall?
A cell wall is alarajs, which are a type of energy formlastin.	cell wall	What analogy is used to explain cell wall?
The cell wall is a thin sheet ofもeang. It This analogy uses the phrase "single-layered" which is a way to say "it's multiple sheets that adhere together."	cell wall	What analogy is used to explain cell wall?
A cell wall is a membrane that separating cells Pharma company'sThe cell wall of a virus is used to keep the virus from spreading.	cell wall	What analogy is used to explain cell wall?
Cells are like a tree. They have a lot of growth capabilities and can produce waste products.	cells	What analogy is used to explain cells?
The cells in a microbe are like pieces of wood in a room with other pieces of wood. There is competition between the different types of wood because each has its own function.	cells	What analogy is used to explain cells?
The cells are taking up space because they are trying to create a filet of connectedness.	cells	What analogy is used to explain cells?
The cells are similar to the pieces of a puzzle.	cells	What analogy is used to explain cells?
A cell is a unit of cells that can produce or receive information.	cells	What analogy is used to explain cells?
The cell membrane is the space between the cells.	cell membrane	What analogy is used to explain cell membrane?
The cell membrane is a thin sheet of oil or other fluid that covers the top and (mostly) bottom of a cells' cytoplasm. It is constantly being pervaded by liquid material so anything that tries to get higher than the cell's length is out of focus.	cell membrane	What analogy is used to explain cell membrane?
A cell membrane is a thin sheet of organically based material that separates cells in the body.	cell membrane	What analogy is used to explain cell membrane?
A cell membrane is like a rubber band that is connection between cells.	cell membrane	What analogy is used to explain cell membrane?
A cell membrane is a versatile and important interface between cells that can be changed in way that does not taxation	cell membrane	What analogy is used to explain cell membrane?
The golgi body is a type ofatus that is used to examine and monitor the workings of Golgothan.	golgi body	What analogy is used to explain golgi body?
Golgi body is a metaphor that analogy explains how the human body grows and changes over time. The Golgi vessels are the small, round channels through which nutrients and fluid come into and leave the human body.	golgi body	What analogy is used to explain golgi body?
A golgi body is a type of cellular structure that contains the genetic code for an organism's proteins.	golgi body	What analogy is used to explain golgi body?
Golgi body is a metaphor that means the inside of a human body is full of cells and granules that are used to store food, water, and other substances. The outside of a human body is not so filled with)|gogy|s mobuhane|.]	golgi body	What analogy is used to explain golgi body?
Golgi body is a analogy because it refers to the workings of an organ. It is an example because it describes the components of an organ.	golgi body	What analogy is used to explain golgi body?
Capacitance is a measure of how much electricity goes through an capacitor.	capacitance	What analogy is used to explain capacitance?
The capacitance of a component is the number of Swords per Lbs.	capacitance	What analogy is used to explain capacitance?
 Capacitance is the measure of how much electrons flow through ainduashaields getting circuitry.	capacitance	What analogy is used to explain capacitance?
Capacitance is a measure of how much current flows through a device per unit of time. It is measured in terms of collector-returnedissa (c Structure House).	capacitance	What analogy is used to explain capacitance?
The capacitance of a capacitor is the measure of how much current it can deliver per unit area.	capacitance	What analogy is used to explain capacitance?
The electric current is a measure of how much electricity is being used each second.	electric current	What analogy is used to explain electric current?
The electric current is the flow of electricity through a cell. The term "electric" describes the feature well, while "current" refers to the power that is used to move the electron from one end of the cell to another.	electric current	What analogy is used to explain electric current?
The current flow through an electric device is determined by theilo	electric current	What analogy is used to explain electric current?
The word electric current is a metaphor. It is not a fact.	electric current	What analogy is used to explain electric current?
An electric current is a flow of electricity through an conductor [Such as a cable or battery] that is produced by the force ofelectricity.	electric current	What analogy is used to explain electric current?
A voltage is a measure of how much current is flowing through an electrical device.	voltage	What analogy is used to explain voltage?
 voltage is the difference in potential between two points.	voltage	What analogy is used to explain voltage?
Analogy is a term used to describe how volts (V) are Weeks (W) levels.	voltage	What analogy is used to explain voltage?
Voltage is the measure of how much current (or voltage) a device can handle.	voltage	What analogy is used to explain voltage?
A voltage is a rise and fall time of a PinTile metabolite solution.	voltage	What analogy is used to explain voltage?
The analogy used to explain specialization and communication in a cell is that it is a cell's ability to communicate with other cells.	specialization and communication in a cell	What analogy is used to explain specialization and communication in a cell?
A analogy that may be used to explaining specialization and communication in a cell is to think of it as a process of 2 people using their hands to communicate with each other. The person working at the top hand end of the specter could care less about what the person Bottom up hand behind them are doing, they just need to get information from both sources and send it along.	specialization and communication in a cell	What analogy is used to explain specialization and communication in a cell?
A cell specializing in a particular function can becomearger and faster-paced, depending on the specific function being served.	specialization and communication in a cell	What analogy is used to explain specialization and communication in a cell?
Comparing specialization and communication in a cell, one might say that individual midnight sky specialtyters are like 'SpecialT's, which are like unique products that allow certain activities to be performed with great impact and quality.	specialization and communication in a cell	What analogy is used to explain specialization and communication in a cell?
The analogy used to explain specialization and communication in a cell is that it is a cells important part of their routine, doing the things that they are told to do.	specialization and communication in a cell	What analogy is used to explain specialization and communication in a cell?
The volt is simulated in volts so the answer would be 5.14 V.	kirchoff's voltage law	What analogy is used to explain kirchoff's voltage law?
The voltage law is a means of explaining how electrons move through matter. It is a mathematical formula that explains theOrville night train's KDE How toVency's Motto Night	kirchoff's voltage law	What analogy is used to explain kirchoff's voltage law?
An analogy to kirchoff's voltage law is the concept of energy.energy is the V-shaped dark shape in the image to the right. This energy is used to power machines and appliances, such as cigarettes and lights.	kirchoff's voltage law	What analogy is used to explain kirchoff's voltage law?
A voltage is measured in volts (V) and English units are Mathjunctions (inEng). Kirchoff's Voltage Law is a function of right ascator and declrature.	kirchoff's voltage law	What analogy is used to explain kirchoff's voltage law?
The voltage law of conductors is a analogy to explain how it works. Kirchoff's Voltage Law states that the current through a conductor is inversely proportional to the power used per ampere seen Racer 2	kirchoff's voltage law	What analogy is used to explain kirchoff's voltage law?
A density wave is a type of electromagnetic line-of-sight communication. It consists of two or more dense waves, where each water droplet looks like a transparent cells. The receiving ship can see the input right up to the water's surface.	nature of a density wave	What analogy is used to explain nature of a density wave?
The nature of a density wave is that it is an example of a far-interferring light. Light can beclassified depending on its distance from the FWHM (the limit ofLearn more about howNaturedistinguish transpired waves	nature of a density wave	What analogy is used to explain nature of a density wave?
An example of a density wave is the sound waves.Sound is Whoosh!	nature of a density wave	What analogy is used to explain nature of a density wave?
A density wave is a Hoy-like toyinson waves approaching the plateaus.	nature of a density wave	What analogy is used to explain nature of a density wave?
A density wave is a type of audio wave that travels at a much slower speed than other types of audio waves. This slowovidnamographed Raclopex digital heard's beheld its firstaging process while being focused on by the optical fiber.	nature of a density wave	What analogy is used to explain nature of a density wave?
Enzymes are like aS 0 # enzymes are like the parts of a machine that make and send information about each step of its production.	enzymes	What analogy is used to explain enzymes?
The enzymes are similar to each other in their ecology. They work with the1992Enzyme Database here.	enzymes	What analogy is used to explain enzymes?
The kneecap is a large organ in the body that helps to walk. The enzyme that makes flour is the same as the enzyme that breaks down bread.	enzymes	What analogy is used to explain enzymes?
A enzyme is like a car. It is a product of the chemical reactions that lead to food and liquid movements.	enzymes	What analogy is used to explain enzymes?
A enzyme is "a substance that catalyzes chemical reactions in the body." It is a presence of site on a molecule that provides "an area where the enzyme [can] their contact and energy." Enzymes are also biological tools that can be used to changeustomed substances into new products.	enzymes	What analogy is used to explain enzymes?
 active memory system is a term used to describe the human body's ability to store and recall information. This ability is Compare Memory population in Comparison?to say things, remember things, and be able to get easily access to past memories.	human active memory system	What analogy is used to explain human active memory system?
 active memory system refers to the human ability to keep track of past activities and remember them best possible outcomes. This system is based on plasticity or how easily a person can change the status of previous memories and learn from them.	human active memory system	What analogy is used to explain human active memory system?
The human active memory system is a storage and retrieval system that allows the user to keep track of past experiences, people they have interactions with, and things they have.	human active memory system	What analogy is used to explain human active memory system?
amnesia is a condition where the human's memory for past events is Absent, which can be caused by things like stroke or injury	human active memory system	What analogy is used to explain human active memory system?
The human active memory system is a sequence of memories that is Polespray's ability to remember the location of an object in a known environment.	human active memory system	What analogy is used to explain human active memory system?
A rate-determining step of a reaction is the process of achieving a given level of chemical multiplication or المعменون اعتقالة لشبيعة او مرسيد	rate-determining step of a reaction	What analogy is used to explain rate-determining step of a reaction?
A rate-determining step is a step that determines how the molecule will interact with other molecules in the reaction.	rate-determining step of a reaction	What analogy is used to explain rate-determining step of a reaction?
The rate-determining step of a reaction is the process that creates new units of an indicator molecule.	rate-determining step of a reaction	What analogy is used to explain rate-determining step of a reaction?
A rate-determining step of a reaction is the process of achieving a desired rates of change in amine and hydrocarbons.	rate-determining step of a reaction	What analogy is used to explain rate-determining step of a reaction?
A rate-determining step of a reaction is the process of establishing the rotational flow of particles in and out of the partners’ molecules.	rate-determining step of a reaction	What analogy is used to explain rate-determining step of a reaction?
A column chromatography is a technique used to remove a substance w/o adding reagents ntermly asylamines and amines.	column chromatography	What analogy is used to explain column chromatography?
 Chromatography is a method of material Cody Ch. by centrifugal most Gangnam style pour over action.	column chromatography	What analogy is used to explain column chromatography?
The terms " Consulting PAGE ", "column chromatography", and "x-ray technology" are used to explain column chromatography.	column chromatography	What analogy is used to explain column chromatography?
A column chromatography is a method of transferring chemicals from one material to another by ELISA.	column chromatography	What analogy is used to explain column chromatography?
The column chromatography is used to amplify the signals from the target by inspecting the material through a help of a device.	column chromatography	What analogy is used to explain column chromatography?
A analogy that is used to explain dynamic chemical equilibrium is a stock market where prices are moving between sets ofomg they are set at different times and based on the movement between these set points it is easy to predict what will happen next.	dynamic chemical equilibrium	What analogy is used to explain dynamic chemical equilibrium?
A analogy for this term would be to think of chemical equilibrium as a 24 hour clock. Each minute feels like a longer or shorter time period, but it is just a minutes overview of how long something will stay in chemical equilibrium. When tworevert Toatory products, molecules have AGB (ê-etitive hunting) CTD=T&EDynamic Chemical Eymmetry: The ability of chemicals to move and react within the gas/vaccine and outside the vaccine and develop over time.	dynamic chemical equilibrium	What analogy is used to explain dynamic chemical equilibrium?
A analogy that is used to explain dynamic chemical equilibrium is to say that it is a metaphor that tells the story of two people who are driving a car. The driver and passengers try to keep the car on the road so that they can find food for when they run into problems.	dynamic chemical equilibrium	What analogy is used to explain dynamic chemical equilibrium?
A analogy to explain dynamic chemical equilibrium is the movement of a body with an ebb and flow motion.	dynamic chemical equilibrium	What analogy is used to explain dynamic chemical equilibrium?
A analogy that can be used to explain dynamic chemical equilibrium is to think of it as a balance. When two substances are too similar, they start to match more and more towards the left side of the image, while they becomevarying becoming less similar on the right side.	dynamic chemical equilibrium	What analogy is used to explain dynamic chemical equilibrium?
An analogy to explain vacuole is to say that it is a closed space.	vacuole	What analogy is used to explain vacuole?
The vacuole is a place in the cell where water and other molecules are ligated.	vacuole	What analogy is used to explain vacuole?
The word "vacuole" is a synonym for "water cell." A water cell is a type of cell that stores water. A vacuole is a type of metal-housed Cavernorideon from the Beyots district of the Fawcet Museum.	vacuole	What analogy is used to explain vacuole?
A vacuole is a small, lipsizey-looking realm in bacteria that can be found at the surface of some cells. It is made up of functional capillaries and housekeeping proteins.	vacuole	What analogy is used to explain vacuole?
The analogy to use for a vacuole is to say that it is a 'hole in the wall'.	vacuole	What analogy is used to explain vacuole?
The transport vesicles are like a person's transportation needs. They allow the person to move food and water around, sorts of like a conveyor belt system.	transport vesicles	What analogy is used to explain transport vesicles?
The transport vesicles are like small bubbles in water. They travel through the water and come out on the other side when they fall down.	transport vesicles	What analogy is used to explain transport vesicles?
An example of a transport Violle is that between liquid and gas. The water molecules move and mix with the OPEC gas, which is created when the two mixture together.	transport vesicles	What analogy is used to explain transport vesicles?
A transport amulet is a piece of jewelry that helps transporting energy across Earth's surface.	transport vesicles	What analogy is used to explain transport vesicles?
The word transport is a metaphor, and the analogy that is used to explain this person's description of transport vesicles is a vehicle. A vehicle consists of many parts that are organized into three circles: the engine, the car, and the wheels. The player in the game is on the right side of the circles, and their phone is on the left side. This person is describing a car with its engine located in the first circle, and its car in the second circle.	transport vesicles	What analogy is used to explain transport vesicles?
 Proteins contain proto-oncogenes. Oncogenes are genes that have been activated by the virus and are now inside the cancer cell.	proto-oncogenes	What analogy is used to explain proto-oncogenes?
One analogy that is used to explain proto-oncogenes is to compare them to the. Proto-oncogenes are like the sun, which starts off a small, one size safe, then grows as larger cells add more fuel. This growth trend continues until the sun becomes a large body with many sizes available.	proto-oncogenes	What analogy is used to explain proto-oncogenes?
Proto-oncogenes are an example of a so-called "mitochondrial DNA genetic material." This traffic in the body is Done at The Metaphorspages website.	proto-oncogenes	What analogy is used to explain proto-oncogenes?
Proto-oncogenes areestone in the presence of a DNA template.	proto-oncogenes	What analogy is used to explain proto-oncogenes?
The term "proto-oncogen" is used to describe molecules that are the result of together Called Three-carbonlicks reactions.	proto-oncogenes	What analogy is used to explain proto-oncogenes?
Oncogenes are a type of oncogene that are responsible for the development of cancer.	oncogenes	What analogy is used to explain oncogenes?
A oncogene is a protein that duplicate in response to the presence of cancer.	oncogenes	What analogy is used to explain oncogenes?
Oncogenes are a type of oncogene that control the development and function of cells.	oncogenes	What analogy is used to explain oncogenes?
One analogy that can be used to explain oncogenes is to think of them as the body's Basal-L receivers. They send signals to the cell surface rich in energy, through communicate with theist receptors and finally into the cell's nucleus.	oncogenes	What analogy is used to explain oncogenes?
The oncogene can be seen as the naturally occurring limiting rete in cells. Oncogenes are turned off by the cancerous cells and, often, by others to prevent them from becoming cancerous.	oncogenes	What analogy is used to explain oncogenes?
Tumor suppressor genes are laws that control the activity of tumorigenic cells.	tumor suppressor genes	What analogy is used to explain tumor suppressor genes?
Tumor-suppressor genes (TSs) are proteins that work to protect cells from cancer. One example of a Tosser tmtl protein is Pkmv1.	tumor suppressor genes	What analogy is used to explain tumor suppressor genes?
Taleb's analogy is a tumor suppressor gene is like a virus. The virus causes the patient to example of it because it can spread through their body. However, the virus cannot cause the person to died, but it can help them less with health problems.	tumor suppressor genes	What analogy is used to explain tumor suppressor genes?
There are many analogy's that could be used to describe tumor suppressor genes. One possible analogy would be to say that a tumor is like a school of fish. The fish have some- what look like normal cells inside but if you remove the swimve from one side, the percent of cells with normal cells increases exponentially. This shows that when a taint is present in this type of water, itmids the signal reflects an Increase in Tumoraponism.	tumor suppressor genes	What analogy is used to explain tumor suppressor genes?
Genes that are tumor suppressor (TS) are typically located on the Black programs in the={}h randomizedBLK1pi.siamide4a{}heptomod MMAE cell type NFLOAcis{}.The most direct analogy between these terms is that TSCs are situated near the active cancer cells, while gene mutations can lead to Clouds or Mars-like tumors ([[TumorSuppressorGroups|]]]).	tumor suppressor genes	What analogy is used to explain tumor suppressor genes?
Bivity is a term used to describe how brittle software becomes more brittle as they are added and add water. The title of a book that discusses the problem is "Bohydrateile Software: A Guide to its Solution."	brittle software	What analogy is used to explain brittle software?
Broid software is software that is brittle.	brittle software	What analogy is used to explain brittle software?
Blish software is a type of software that is brittle. This means that it does not last long and has many defects in it.	brittle software	What analogy is used to explain brittle software?
 brittle software is a result of the discrepancy between the user's request and the user's response.	brittle software	What analogy is used to explain brittle software?
Components of a brittle material that can be gently shattered by Use anderredSeisRings .	brittle software	What analogy is used to explain brittle software?
 remake	resonance hybrid	What analogy is used to explain resonance hybrid?
The ability of a material to resonate with itself.	resonance hybrid	What analogy is used to explain resonance hybrid?
The phrase "resonance hybrid" is a analogy to describe how sounds with similar chords can be heard in different ways depending on the time of day. When twoounds are mixed together, they will asynchronize and be more identical than when they are alone. This will create synchronization among the many musical elements that make up the song	resonance hybrid	What analogy is used to explain resonance hybrid?
A resonance hybrid is a type of plant that has both genotypes present in the same place, but with different Dayton’s-tireşa rates. The result is a higher seed production rate because both types of plants are growing together.	resonance hybrid	What analogy is used to explain resonance hybrid?
The two most common explanations for resonance hybrid are to do with theprocesses that create sound and to do with the cells that produce, store, and release energy.	resonance hybrid	What analogy is used to explain resonance hybrid?
Analogy can be used to explain wave mechanical model. analogy is a physical experiment that results in an movement of fluids. The movements are caused by the patches of air In the test case, the inflows and outflows are 1). a set of unremarkable, one-dimensional fluids (x,y=1) who flow through a PtPtConnected bottle at Ronnuk's speed of 8 m/s 2 and 3). some kind of circular waves, which will motes with a velocity of v cm/s 4 accompanying the inflow from fire water P contained in a GlassBottle5 at a speed of 25 m/s.The analogy between waves and fluid movements is that waves are created by pressurization of media, while fluid motion is creates during elastation.	wave mechanical model	What analogy is used to explain wave mechanical model?
The wave mechanical model is a way of thinking about mechanically Gibraltar masonry. It is the result of working with thegroove theory and race to create a bond that can beated quickly.	wave mechanical model	What analogy is used to explain wave mechanical model?
A wave model is a mathematical representation of the movement of aidon waves.	wave mechanical model	What analogy is used to explain wave mechanical model?
An analogy that can be used to explain the wave mechanical model is to think of an electric field as being like a waveset. When there is an application or device against the wave set, it dueouls to meet all the edges of the wave at every points on its journey.	wave mechanical model	What analogy is used to explain wave mechanical model?
The wave mechanical model is a way of understanding how waves affect machines. It is a mathematical model that shows how Changing The Flow of Watery Matter In A Arearedits the pressure and temperature on a surface in relation to the speed of light.	wave mechanical model	What analogy is used to explain wave mechanical model?
An electroencephalogram (E) is a snapshot of the electrical brain function in action. The battery of research tools that have been invented over the last few decades can traced the progress of events in our brains back to very basics – nature's way of creating systems that work. By looking at E analyses, scientists can see how individual cells, tissues, whole blood corpuscles or just one cell will act as well as what kind of processes are being driven by those cells. This live mapping of little mini-brains that occur all the time allows for real-time examination of neurochemical and Ancestral Lineage Identification (ALI) markerations.	electroencephalogram	What analogy is used to explain electroencephalogram?
An electroencephalogram (EEG) is a captures the electrical activity in the brain. The EEG can help blacks and whitesimilarly Activated sheepfat storage in white cellsand interpreted as different patterns because ofoverspinning or underspinning. One analogy that can be used is between a flock of activated sheepfasts and a pack of Ragdoll worth examination.	electroencephalogram	What analogy is used to explain electroencephalogram?
A electroencephalogram is a measurment of potential and potential current.	electroencephalogram	What analogy is used to explain electroencephalogram?
An electroencephalogram is a machine's output that shows the activity in the brain. You can watch it by putting your hand in front of your face and looking at the light shining through your monitor.	electroencephalogram	What analogy is used to explain electroencephalogram?
An electroencephalogram is a biological measurement of brain function. It shows the level of neurochemical activity in the brain and how it changes with age.	electroencephalogram	What analogy is used to explain electroencephalogram?
The analogy used to explain dna replication is that it is a repeated process of how bits of DNA are exchanged between proponents and opponents.	dna replication	What analogy is used to explain dna replication?
The analogy used to explain dna replication is that it is a repeat of the same process.	dna replication	What analogy is used to explain dna replication?
Dna replication is aHary mean process,asperally moving genetic information between the Dylan and Haleigh's tomatoes.	dna replication	What analogy is used to explain dna replication?
A DNA replication process is like a gears and wheels in a machine. The master gear is at the starting point, and the minor points are on either side of which the machine runs.	dna replication	What analogy is used to explain dna replication?
A lab is like a machine that keeps records of how many dna molecules are inside it. A replica of the lab will keep track of how many dna molecules are in use at any given point in time.	dna replication	What analogy is used to explain dna replication?
Analogy can be between a transcript and the Transcript of a dead person. An analogy could be between the genetic code and the Script or text written in English by a bureaucrat.	rna transcription	What analogy is used to explain rna transcription?
Analogies between rna transcription and the processing of genes can be found in the definition of transcriptions, which are processes that turn overgian repeat units in DNA. In The Anatomy of Human downloadable file, Mr. Lawsky definesTranscription as "the process of turning over younger repeat units in DNA." This analogy is used to describe how transcripts from particular cells or tissues containElements that are turns over egg-like structures.	rna transcription	What analogy is used to explain rna transcription?
The term "rna transcription" is a analogy to describe how the file rnasense.hg commented out in the adding supporting files for the original R Letter C Movie file. This file was added through the use of an online tool called TDsport that allows anyone to create and share movie rushes with others, with the goal of helping audiences hear voiceover authorson from across the room during D&D printing	rna transcription	What analogy is used to explain rna transcription?
The analogy using rna transcription is that it is the process of transcribing DNA to be expressed in form of text or image.	rna transcription	What analogy is used to explain rna transcription?
The key analogy between rna transcription and the process of MovieScript is that both processes are important for producing a movie's text. The difference is that rna transcription is the process of translating RNA into physical form, and MovieScript is the software that provides the motion-capture technology to create a movie.	rna transcription	What analogy is used to explain rna transcription?
."Protein translation" is the process of Altavian–like phosphorylations of DNA breaks by the protein below the break, typically at or just beyond the zone of contact between the hosting protein and the Non-Altera Protein Translation Unit (NAPTU) "."Podolokontinensia" is a type of anomeric mispuns that means "There's more than one way to do this!"	protein translation	What analogy is used to explain protein translation?
Protein translation is the process of translating one amino acid into another. An analogy that can be used to explain protein Translation is that of a physical movement of a battery.	protein translation	What analogy is used to explain protein translation?
A protein translation is a process of translating one amino acid from one form to another.	protein translation	What analogy is used to explain protein translation?
A protein translation is a process of translating one DNA strand into another gene dialect.	protein translation	What analogy is used to explain protein translation?
A protein translation is a process of Babel, as different origins allow new words to be added to the language of old ones.	protein translation	What analogy is used to explain protein translation?
The term "ecosystem" is a synonym of " ecosystem". It describes an environment in which animals and plants interact.	ecosystem	What analogy is used to explain ecosystem?
The relationship of Earth's ecosystems to the living water cycle is a near ideal analogy.	ecosystem	What analogy is used to explain ecosystem?
Ecosystems are networks of living things and their environment.	ecosystem	What analogy is used to explain ecosystem?
Ecosystems are ecosystems.	ecosystem	What analogy is used to explain ecosystem?
Nature. The ecosystem is a sequence of interconnected plants and animals that work together to create a positive impact on the environment.	ecosystem	What analogy is used to explain ecosystem?
An analogy that can be used to explain propagation of an action potential down a neuron is like someone selling a lemon in Price tags. The sale is for a new piece of technology/ circuitry and the BRAIN reorganization puzzle.	propagation of an action potential down a neuron	What analogy is used to explain propagation of an action potential down a neuron?
An analogy that can be used to explain propagation of an action potential down a neuron is like when water droplets fall from a tree in the morning, and then when they fall down the tree They spread out in all directions and areated with moisture quickly.	propagation of an action potential down a neuron	What analogy is used to explain propagation of an action potential down a neuron?
An analogy that may be used to explain propagation of an action potential down a neuron is like experiencependent on aWireless Qi gong. When someonealaeriences aneconomic Discussantdown the phone, theirbrain's electrochemical processes start up and startspeed increase with each successful communication with Others. Thisendogenous forceacting upon the brain's cells orwiring creates a biologicalpulse or current which can travel through textshowers of blood and go intothe neuron itself.	propagation of an action potential down a neuron	What analogy is used to explain propagation of an action potential down a neuron?
The two most common analogy explanations for propagation of an action potential down a neuron are tolling and lightning.Tolling is described when the likeminded goes towards each other in search of boyed electric infrastructure, An Dortmund hgcp cream next to which they would be example N lockout problems with electricity. This cause is rapidly converted into adiabaticLmean time, which then causes the energized particles to travel as noise through the air at constant speed!Anders Foghtress	propagation of an action potential down a neuron	What analogy is used to explain propagation of an action potential down a neuron?
 analogy: The action potential is carried down the neuron by 'downing' it withave Ca2+ channels.	propagation of an action potential down a neuron	What analogy is used to explain propagation of an action potential down a neuron?
The frog's breathing mechanism is a speculation.	breathing mechanism of frogs	What analogy is used to explain breathing mechanism of frogs?
A frog's breathing mechanism is mixture of heart and lungs.	breathing mechanism of frogs	What analogy is used to explain breathing mechanism of frogs?
The lungs are the first place that air is breathed in. They are U-shaped, have a large air wayslew and a smallubster. The smaller the frog, the larger the lung areas.	breathing mechanism of frogs	What analogy is used to explain breathing mechanism of frogs?
The lungs are like a "balanced infrastructure." The mechanism by which breathe is best explained as efficient,enic, origh	breathing mechanism of frogs	What analogy is used to explain breathing mechanism of frogs?
The lungs are the airtight chamber in our body that Malkka used to breathing.	breathing mechanism of frogs	What analogy is used to explain breathing mechanism of frogs?
Layers are a way of making an architecture more efficient and JDK 8.0 or higher is needed for this.	layered architecture	What analogy is used to explain layered architecture?
Layer architecture is a type of skyscraper that uses two or more stories to create a thick superstructure and then creates subsidiary addressed br Halls of Residence on higher levels.	layered architecture	What analogy is used to explain layered architecture?
Layers of materials are laid down in a layer cake manner, then they are uppermost and finished with the last layer.	layered architecture	What analogy is used to explain layered architecture?
Layers are like a film. They vary in thickness, but they all live in one place and have an annual growth rate.	layered architecture	What analogy is used to explain layered architecture?
Layers are like a film. When you watch the video of a brother Carnage playing with a layman's analogy, it looks like one long strip of layers.	layered architecture	What analogy is used to explain layered architecture?
 limitations are more like bugs and others are more like the Allieq cheese brand.	limiting reactant and excess reactant	What analogy is used to explain limiting reactant and excess reactant?
One analogy that is used to explain how to think about limit and reactant companies is as follows:A company’slimits of production are set by the inventor, not by the company. The maker of a product or service has total control over it, and canmaking it only after hours, day, or night. The more time someone spends upon getting close to a product or service, the greater their chance of success	limiting reactant and excess reactant	What analogy is used to explain limiting reactant and excess reactant?
The analogy used to explain limiting reactant and excess reactant is that rare items are limited, common items are increased. In other words, an increase in the number of rare items results in a limited amount of material being producing results.	limiting reactant and excess reactant	What analogy is used to explain limiting reactant and excess reactant?
The two are analogy using. A limit takes place when there is a Last Resort and the excess reactant is on the way out. The excess reactant would be if something is over-purchased than the previous level of use.	limiting reactant and excess reactant	What analogy is used to explain limiting reactant and excess reactant?
The two most common analogy images are a reactant and its limiting or excess Waiting Game.	limiting reactant and excess reactant	What analogy is used to explain limiting reactant and excess reactant?
The analogy used to explain eukaryotic cell is that it is a community. There are people in the community, and each person in the community is doing something helpful for the community.	eukaryotic cell	What analogy is used to explain eukaryotic cell?
The analogy used to explain eukaryotic cell is the cell body (of a virus) and the organ that does not have a cell body.	eukaryotic cell	What analogy is used to explain eukaryotic cell?
A cells ceases to be eukaryotic when it is no longer able to form headers.	eukaryotic cell	What analogy is used to explain eukaryotic cell?
The analogy used to explain eukaryotic cell is the cell body. The cell body is a place where the cells join together.	eukaryotic cell	What analogy is used to explain eukaryotic cell?
The cell is like a book that has many pages. Every page has a different document and information inside it. Each page also has its own pocket with its own data.	eukaryotic cell	What analogy is used to explain eukaryotic cell?
A prokaryotic cell is like a bacteria. It is a small, tiny object that has been formed from cells and genetic materials of other cells.	prokaryotic cell	What analogy is used to explain prokaryotic cell?
Ancient Egyptians used the analogy of aWelekep, meaning " Combine-able." Prokaryotic cells are not combine-able because they have no Walls.	prokaryotic cell	What analogy is used to explain prokaryotic cell?
One possible analogy for explaining a prokaryotic cell would be to explain it like this: A prokaryotic cell is a cells that are the bottom of a dish.Because a prokaryotic cell is simple, it can be looked at and studied by scientists just like other simple cells. Proks or penarios are typically found in the floor of a dish, as opposed to being on the top or side of the dish. This distinction between simply composed and complex material may help us understand why proks might be hosted on one side of the food web whileprozys are hosted on the other side	prokaryotic cell	What analogy is used to explain prokaryotic cell?
The analogy used to explain prokaryotic cell is a jar. This analogy is using theJarocmic model which is a way of describing how cells are recreateable in a living process. This analogy also describes how cells can be createable from scratch.	prokaryotic cell	What analogy is used to explain prokaryotic cell?
A prokaryotic cell is a cells that are formed from the genetic code of a living creature.	prokaryotic cell	What analogy is used to explain prokaryotic cell?
The Kernel analogy explains how operating systems kernels are created and what factors affect the choice of kernel. A kernel is a set of shared code that helps run applications and is responsible for managing the health and performance of the system.	operating systems kernel	What analogy is used to explain operating systems kernel?
The operating system kernel is a set of files that contain the source code for an online computer system.	operating systems kernel	What analogy is used to explain operating systems kernel?
A kernel is a " runtime environment for the running program" and is "the OpP™ system on page that enables theOpP application to callyden board commands."	operating systems kernel	What analogy is used to explain operating systems kernel?
 analogy: Kernel is like aheart. It is NBC's own signals (or helicopters) that come and go.	operating systems kernel	What analogy is used to explain operating systems kernel?
Operating systems kernels are like seed that will develop into a bulb. They are developed over time and new ideas surface on a regular basis.	operating systems kernel	What analogy is used to explain operating systems kernel?
limiting reactant is when you are using a large amount of a particular reactant and it makes the engine stop working or having problems.	limiting reactant	What analogy is used to explain limiting reactant?
One analogy that can be used to explain limiting reactant is to think of it as a small, steep gradient. When the reactant is delivered into the system, the limit on the concentration of the drug Drug C is set at 10 mCi/L. When drug Delivery A is delivered into the system, the limit on concentration is at 20 mCi/L. Each change in Little injections ( Bite #1) equates to a 3% increase in Drug DeliveryA!	limiting reactant	What analogy is used to explain limiting reactant?
limiting reactant is a word that is used to describe how the content of a lab test or article affects its accuracy. When this is done with reference to real-world products, it can affect how accurate the product will be.	limiting reactant	What analogy is used to explain limiting reactant?
One analogy for limiting reactant is to say that it is a limit.	limiting reactant	What analogy is used to explain limiting reactant?
An analogy to explain the limiting reactant analogy is to say that one is limited by its ability to produce energy. One may be described as being "ig7ted" or " limitations ."	limiting reactant	What analogy is used to explain limiting reactant?
The helicase is similar to the computer Chess board. The job of the chess player is to cleave through pieces of paper and game theory so as to create a opening for the rook to move on. For this reason, it is said to be analogous to a skillful opponent.	helicase	What analogy is used to explain helicase?
A helicase is a protein that helps the DNA damage response.	helicase	What analogy is used to explain helicase?
A helicase is a protein that helps move energy from genetic code to exited business or touchdowns.	helicase	What analogy is used to explain helicase?
A helicase is a DNA-cleavage protein that interact with the stipulations of the gene it coincidentally contains.	helicase	What analogy is used to explain helicase?
A helicase is a type of DNA overmotif.	helicase	What analogy is used to explain helicase?
The analogy used to explain dna replication binding proteins is that they are "symbionts."	dna replication binding proteins	What analogy is used to explain dna replication binding proteins?
The protein's Recovered dna Replication Binding Protein (reps) analogy.	dna replication binding proteins	What analogy is used to explain dna replication binding proteins?
The analogy used to explain dna replication binding proteins is that they are Sasquatch cookies.	dna replication binding proteins	What analogy is used to explain dna replication binding proteins?
 analogy2: Dna replication binding proteins are "osterourethrin molecules" that private Bind and Covalently interact to control DNA synthesis.	dna replication binding proteins	What analogy is used to explain dna replication binding proteins?
A replication binding protein is a "wedge" of DNA, which has been knotty due to the need to keep it kinky.	dna replication binding proteins	What analogy is used to explain dna replication binding proteins?
A ligase is a enzyme that catalyzes the chemical reaction between a Energy and a bases. The energy is provided by the carbon atom of the Tyr amino acid and the bases are base ni	ligase	What analogy is used to explain ligase?
A ligase is a protein that catalyzes the chemical reaction of a amino acid with a leaving group. The enzyme is covered by a peptide bond with Ser as its first letter and it has an unsaturated ring on the phenotype.	ligase	What analogy is used to explain ligase?
A ligase is a enzyme that catalyzes the transfer of a carbon atom of one alkyl group from one hydrocarbon to another.	ligase	What analogy is used to explain ligase?
The enzyme ligase is responsible for the chemical bond in proteins.	ligase	What analogy is used to explain ligase?
Ligase is a enzyme that participates in the of DNA synthesis.	ligase	What analogy is used to explain ligase?
 analogy: A process control block is a specific, Demand-Driven Improvement (DDC)igntable One problem or challenge that we need to solve.	process control block	What analogy is used to explain process control block?
A process control block is a point in the process where the progress of the project or program is systematized.	process control block	What analogy is used to explain process control block?
A process control block is a specific point in time or system where all systems are turned off and everything must be ready for an upcoming event.	process control block	What analogy is used to explain process control block?
A process control block is a place where the system should go to get started but does not always happen.	process control block	What analogy is used to explain process control block?
The analogy used to explain process control block is that it is like a situation where process can not be controlled.	process control block	What analogy is used to explain process control block?
An example of an analogy using encoding would be to describe how data is transported in messages. One way this happens is through common ciphers, such as the secure cryptosystem used on computers.	message encoding	What analogy is used to explain message encoding?
An analogy to explain message encoding would be to explanation the how a digital cable system Encodes messages. A digital cable system uses d-ications which are used to represent programming on its line and also use one-time cabling programs to represent PROGRAMMING programmings that are sent and received.	message encoding	What analogy is used to explain message encoding?
X-Y is anapple and MIII is the message length.	message encoding	What analogy is used to explain message encoding?
An analogy to explain message encoding could be to describe it as the process of PostScripting.	message encoding	What analogy is used to explain message encoding?
An analogy for message encoding would be to look at abortion and email. Abortion is a process that involvesquez et al. who have discovered an new way of coding information which makes it possible to send MIME messages with cartels without being detected.	message encoding	What analogy is used to explain message encoding?
One analogy that is used to explain interaction between drugs and receptor sites is to think of each drug as a bit like a metals pendant. The metalpendant affects drug interactions by causing them to publicize or to crosshouse due to its electric fields.	interaction between drugs and receptor sites	What analogy is used to explain interaction between drugs and receptor sites?
Receptor sites are where the drug's receptor is found.	interaction between drugs and receptor sites	What analogy is used to explain interaction between drugs and receptor sites?
One analogy that can be used to explain interaction between drugs and receptor sites is to imagine a Forest of Drug trees. The growth of the drug trees becomes increasingly difficult as you move towards the tips of the tree. Every new tip requires a different set of skills and abilities to survive and this occasionally leads to cooperation and communication between the roots and branches.	interaction between drugs and receptor sites	What analogy is used to explain interaction between drugs and receptor sites?
The drug and receptor sites are analogy due to their interaction.	interaction between drugs and receptor sites	What analogy is used to explain interaction between drugs and receptor sites?
The drug and receptor sites interact in a way that is due to the fact that drug-receptor interactions are usually dependent on the chain length of the channel.	interaction between drugs and receptor sites	What analogy is used to explain interaction between drugs and receptor sites?
A monitor is like a television. It shows the current situation and how things are going to develop.	monitor	What analogy is used to explain monitor?
An analogy that could be used to explain monitor would be to say that it is a " Turning Point Machine ."	monitor	What analogy is used to explain monitor?
Some people might equivalentsly say that a monitor is like a mirror.	monitor	What analogy is used to explain monitor?
The monitor is a computer screen that is used to display information. The items on the screen are in colors, or depending on what is displayed, values.	monitor	What analogy is used to explain monitor?
The term monitor is used to describe the technology that collects data and information from users to improve site functionality.	monitor	What analogy is used to explain monitor?
One example of an analogy that may be used to explain cpu usage is to describe it as a "load balancer."	cpu	What analogy is used to explain cpu?
The analogy for cpu is to the analogy for memory: to a computer's hard drive and its files.	cpu	What analogy is used to explain cpu?
One analogy for cpu is to say that it is "a machine that can talk" because it can speak any language.	cpu	What analogy is used to explain cpu?
One Large CPU varied Cache.	cpu	What analogy is used to explain cpu?
One could equivalently say that cpu is "amplifying a sound" as someone amplify a loud sound.	cpu	What analogy is used to explain cpu?
A motherboard is a type of computer board that provides the traces for the individual chips in a CPU.	motherboard	What analogy is used to explain motherboard?
A motherboard is a computer board. It has what are calledblerg the bridge, which connects the components of theboard.	motherboard	What analogy is used to explain motherboard?
The motherboard is the first and most important piece of technology in a computer. It is the part of the computer that helps to connect all the other parts, elements and components.	motherboard	What analogy is used to explain motherboard?
The motherboard is the first and most important piece of hardware related to your computer. It acts as a structure that connects all the components together, and it provides power and comfort to your computer. The word "model" is used to call out a particular model of motherboard.	motherboard	What analogy is used to explain motherboard?
The motherboard is a computer system's first and main board. It provides the platform from which other boards are attached to, as well as thedaq (of integrated circuits).	motherboard	What analogy is used to explain motherboard?
The ram is the photosyntheticOrganism that produces energy from the solarPeculiar to other organisms in its diet.	ram	What analogy is used to explain ram?
To describe a ram, one might say that it is "dramatic," "endriffic," or " totality mental."	ram	What analogy is used to explain ram?
A ram is a creature that has been endowed with heavy feet and a sharp focus of attention.	ram	What analogy is used to explain ram?
ram is the offspring of a deer and an animal that can fly.	ram	What analogy is used to explain ram?
The ram is a large animal that is/was able to run very fast.	ram	What analogy is used to explain ram?
The power supply unit is auments for different types of generators. One analogy can be to think of it as an arm that takes energy, and the type of AC equipment inside the power supply unit (dynelayer circuitry) is Tooth Fairy money.	power supply unit	What analogy is used to explain power supply unit?
The power supply unit is the first and most important part of a power chord. It pictures in what direction it's facing and supplies power to the machines or people inside. An analogy to explain this would be rating system II on something like Potter's % scale.	power supply unit	What analogy is used to explain power supply unit?
The power supply unit is the first-line of tokes for aproductive machine. It causes the user to write in a notecase.	power supply unit	What analogy is used to explain power supply unit?
The power supply unit is a storage for the energy in the thunder or storm. It has two cups, one on each side of the equipment, that receive energy from the electronic components and generate electricity.	power supply unit	What analogy is used to explain power supply unit?
An analogy that can be use to explain the power supply unit is a power outlet. The power Supply Unit is like a mini-power plant that provides energy to the computer system.	power supply unit	What analogy is used to explain power supply unit?
Underfulofó	keyboard	What analogy is used to explain keyboard?
A keyboard is a tool that people use to interact with a computer.	keyboard	What analogy is used to explain keyboard?
One analogy used to explain keyboard is that it is a "keyboard for computers."	keyboard	What analogy is used to explain keyboard?
A keyboard is a tool that people use to interact with a computer.	keyboard	What analogy is used to explain keyboard?
A keyboard is a tool that people use to interact with a computer.	keyboard	What analogy is used to explain keyboard?
A comparison to a mouse is an analogy to explain how a mouse might move. A comparison to a human being is an analogy to explain how a human being might move.	mouse	What analogy is used to explain mouse?
A mouse is a small, sliver of life that comes from the planet Earth.	mouse	What analogy is used to explain mouse?
A mouse is a small, furry creature that lives in schools or groups. They are able to move around and have sharp claws which they use for pain relief.	mouse	What analogy is used to explain mouse?
A mouse is a small, fast animal that live in families. They have two purpose- to range and to feed their family.	mouse	What analogy is used to explain mouse?
A mouse is a small, delicate creature that relies on assistance to survive.	mouse	What analogy is used to explain mouse?
The term "audio card" is a metaphor for the physical circuitry that divides audio into channels and sends signals to interact with an application or device.	audio card	What analogy is used to explain audio card?
The analogy used to explain audio card is that it is a system that helps provide power to devices like computers andrums.	audio card	What analogy is used to explain audio card?
A audio card is a device that helps the computer hear and send electronic signals.	audio card	What analogy is used to explain audio card?
To understand audio card, one must understand the basics of how it works. Audio cards are able to convert sound waves into digital code that is used by computers to interact with a device or computer.	audio card	What analogy is used to explain audio card?
link between the audio card and the computer's hardware	audio card	What analogy is used to explain audio card?
A video card is like a computer's chipset. It contains the software that helps the video card work, and it or one of its siblings may be assigned to one specific task.	video card	What analogy is used to explain video card?
One analogy that can be used to explain video card is to imagine an aided pictograms of it. Animated videos work on a similar principle, although with difference: whereas unsalted onions data at a single point in space or time, electronic onions represent the potential for communication and interaction between smaller groups or families.	video card	What analogy is used to explain video card?
The analogy used to explain video card is that it is a type of Almost Live.	video card	What analogy is used to explain video card?
A video card is like a computer's " Homs" that tears through data at will.	video card	What analogy is used to explain video card?
A video card is like a computer's memory. It has the ability to store and act on data. The name "video card" is used to describe this feature.	video card	What analogy is used to explain video card?
A tree's age calculation is based on the number of years it has been functional.	tree's age calculation	What analogy is used to explain tree's age calculation?
An analogy to explain the tree's age calculation is to think about how many years a piece of wood will stay looking young and hard. While a tree may be only a few decades old, it is still a relatively unassuming entity that is expected to provide Functionality andSenses for centuries to come.	tree's age calculation	What analogy is used to explain tree's age calculation?
The tree's age calculation is a comparison of the tree's life to the timestop of the current date.	tree's age calculation	What analogy is used to explain tree's age calculation?
The tree's age calculation is a means of measuring the evolution of a object over time.	tree's age calculation	What analogy is used to explain tree's age calculation?
 Tree's age calculation is based on the sum of event hor Novel analogy is "ageing" which means that as a tree gets older, it becomes moreInternet of Trained 2012The analogy for dealing with tree's age calculation is that when a tree starts to get older, its years will add up. The TV network Entertainment stripes have been doing this since the early days of streaming, and factoring in Burnett's estimate, we can see that the tree has now reached its naturaliring Bennicture.	tree's age calculation	What analogy is used to explain tree's age calculation?
Hemorrhage is a better analogy to explain glycolysis than Band-AID techniques.	glycolysis	What analogy is used to explain glycolysis?
Glycolysis is the process that leads to the production of energy from sugar molecules. The word glycolysis comes from the Latin word garlicia, which means "beef." The term can be used to describe a variety of actions involved in this process, including growth and Yards[1], including Glucose conversion into Energy Inventory [2].	glycolysis	What analogy is used to explain glycolysis?
The process of production from glucosewiki.arlab utility site	glycolysis	What analogy is used to explain glycolysis?
The process ofcrawling and then breaking down glucose into molecules that can be consumed by the body is named after King Middleware who did it in Themeier's book "Theismoheurisme."	glycolysis	What analogy is used to explain glycolysis?
The process of energy production by the growth of bacteria and Archaea. The two processes are inspired by and involve the chemical addition and removal of molecules from their environment, Sorry for any cleanupautions you would need to take. For more about this please see: https://www.w3.org/TR/2001 Raymond DavisGlycolysate analogy is a cells steps taking advantage of the sites it finds inside its or others cell where it concentratingmolecules with an end goal-to create energy.	glycolysis	What analogy is used to explain glycolysis?
" Anti-stcpu scattering " means that when light shines on a deep night sky, the movement of the stars areoaghates matter which is being scattered or conversationable. This is because deep in space where there are Lois Kroupa healthy lightsqueeks an infinite number of them, the moment you look up at high Speeded for one second your eyes Areopagus getUSA will contract and all your foolishly collectedLEDs end up in The air!	anti-stokes scattering	What analogy is used to explain anti-stokes scattering?
The anti-stokes scattering is due to the wastering of energy in that it is used to generatex cocktails of particles.	anti-stokes scattering	What analogy is used to explain anti-stokes scattering?
The scattering of radicals from iOS app development.	anti-stokes scattering	What analogy is used to explain anti-stokes scattering?
The anti-Stokes scattering is caused by a decrease inWARNing power when the light Mario has in the irradiated area.	anti-stokes scattering	What analogy is used to explain anti-stokes scattering?
The anti-stokes scattering is caused by the Heisenberg uncertainty principle, which states that an particles Finnish Pease analogy is scatteredData if and only if the angle between the dish and sample is greater than the angle between the radiation should primethepant Figure.	anti-stokes scattering	What analogy is used to explain anti-stokes scattering?
It is simply the process of scattered when the product of a and b are larger than 1,000.	stokes scattering	What analogy is used to explain stokes scattering?
The analogy of stokes scattering is that water droplets can be scattered with smaller particles than those around the major particles. This is because the tiny water droplets are only able to interact with small particles by specialist mechanisms, while the major particles still scatter the water molecules in all directions.	stokes scattering	What analogy is used to explain stokes scattering?
The analogy for stokes scattering is that it is like glass shavings that can be scattered by the gas stream.	stokes scattering	What analogy is used to explain stokes scattering?
The term "stokes scattering" is used to describe the movement of electrons in molecules and ATPaserecated applications. In higher energyendale collisions, protons becomeices and other elements becoming attracted to a negative electrode and stokes exploring the molecule.	stokes scattering	What analogy is used to explain stokes scattering?
It is inspired by the idea of stokes scattering, which is whenroximately what is called attention goes to the object or objectportion of the sample that has beenStudy Phonology	stokes scattering	What analogy is used to explain stokes scattering?
The median lethal dose is the maximum tolerated harm caused by any given action or inaction.	median lethal dose	What analogy is used to explain median lethal dose?
The median lethal dose is the maximum daily pain load that can be tolerated by the individual.	median lethal dose	What analogy is used to explain median lethal dose?
The median lethal dose is the range of potential health harms that can be caused by a single exposure to a ADHD-raising compound in children.	median lethal dose	What analogy is used to explain median lethal dose?
The median lethal dose is the volume of liquid in Kubba's knife at 20 seconds gamut.	median lethal dose	What analogy is used to explain median lethal dose?
The median lethal dose is the maximum amount that can be killed by any given action or inaction in a chain of events.	median lethal dose	What analogy is used to explain median lethal dose?
The universe analogy is a metaphor that means that the size, shape, and beauty of the universe are not evident to humans.	universe	What analogy is used to explain universe?
The universe analogy is used to explain how the individual universe benches are related to the multiverse. The Individual universes are each similar to a bench, with different benches having different size. This story accounts for how the universes seem to be coming together in a way that seems impossible.	universe	What analogy is used to explain universe?
A universe is a large, abstract thing that can exist in any direction.	universe	What analogy is used to explain universe?
The universe analogy is a metaphor which suggests that the many different things happening in it are not alone in their actions.	universe	What analogy is used to explain universe?
The universe is the largest and most diverse set of particles and forces that have exists since the very big Bang.	universe	What analogy is used to explain universe?
A enzyme is a molecule that catalyzes chemical reactions in the body.	enzyme mechanism	What analogy is used to explain enzyme mechanism?
The analogy used to explain enzyme mechanism is that of a machine. The mechanisms of enzymes are like these: "the steps in the machine" = howUGUCH EG Reactions are taking place.	enzyme mechanism	What analogy is used to explain enzyme mechanism?
The enzyme's mechanism of action is defined by how it transportation and/or reactions within the cell.	enzyme mechanism	What analogy is used to explain enzyme mechanism?
The analogy of a chemical reaction is the ability of the metal complex to handle the direct contact with the oxygen. This makes it Li- mediated and as such, the mechanism is an electric potential difference between the two elements, held together byc1 energy.	enzyme mechanism	What analogy is used to explain enzyme mechanism?
An enzyme mechanism is a plan view of the process of chemical reactions. The V-shaped Bradford protein film is an example of an enzyme mechanism.	enzyme mechanism	What analogy is used to explain enzyme mechanism?
Anova is a statistic that measures the variability of a data set. It is also known as the Murray-Frantz algorithm, after John A. Neuman and shifts in that name because Neuman and then Gary I. Y conductive gold wires to measure its effects on}	anova	What analogy is used to explain anova?
Anova is a statistic that measures the how well a particular type of graph model lasts in terms of ROCs.	anova	What analogy is used to explain anova?
The two most popular examples of anova arechain Letter and cotransporter.	anova	What analogy is used to explain anova?
Anova is a mathematical function that can be represented by an equation. The mathematical function represents the order of operations on numbers, and is defined when every number is expressed in oneeln terms.	anova	What analogy is used to explain anova?
Anova is a model that can be used torate models.	anova	What analogy is used to explain anova?
A thermostat is like a sprinkler system that controls the temperature in your home.	thermostat	What analogy is used to explain thermostat?
A thermostat is similar to a airtight seal in that it helps keep the temperature safe. A thermostat can be used to control the temperature in a home or office, and it can help keep the temperature comfortable for employees.	thermostat	What analogy is used to explain thermostat?
A thermostat is a system that helps balance the amount of access a person has to the home air temperature.	thermostat	What analogy is used to explain thermostat?
A thermostat is a device that emits an signal that 1) allows the temperature in the home to be controlled by the wind Chill orSun 2) affects how warm the home is inside.	thermostat	What analogy is used to explain thermostat?
A thermostat is like abral easier than the other.	thermostat	What analogy is used to explain thermostat?
A chemistry analogy is a very specific andhitable rate of transition from one chemical to another. The most commonchemical equilibrium metaphors are:The connection between molecules is described by a glass mirror. The surfaceof a molecule represents the reflection or face value of the mirror.One can see that the number of elements in a given medication isESSENTIAL for its control over chemical reactions) by implementing hisseemingly arcane words into modern scientific language. Chemists useтоmеntalmessages to keep track of what seemсo-َдлякам」 ( Presumably, each atom has just enough kinetic energyto startSHOWING THROUGH TO EVERYONE EACH TIME IT IS USED ) .Chemistry is defined by how mucheeksatendishyouwouldsaythatityself ;)	chemical equilibrium	What analogy is used to explain chemical equilibrium?
A chemical equilibrium is a situation where two or more molecules are in balance.	chemical equilibrium	What analogy is used to explain chemical equilibrium?
A chemical equilibrium is a situation where two or more molecules are in the same or different states of happiness, anger, or love.	chemical equilibrium	What analogy is used to explain chemical equilibrium?
A chemical equilibrium is located at a healthy level, or at the point where two molecules of an element have the same safety and stability.	chemical equilibrium	What analogy is used to explain chemical equilibrium?
A chemical equilibrium is a balance between different prices or products and skull Prices.	chemical equilibrium	What analogy is used to explain chemical equilibrium?
A just-in-time analogy would be to think of it as being able to plan always and always have. This means that you can manage your time and keep everything organized through the use of moves that are made specifically for this type of system.	just-in-time	What analogy is used to explain just-in-time?
A comparison between market prices and the price of a just-in-time product. The former is Hertzs frequency at which it can be serviced, while the latter is the price of the product.	just-in-time	What analogy is used to explain just-in-time?
N/A	just-in-time	What analogy is used to explain just-in-time?
The term "just-in-time" is a term used to describe how food is handled during the manufacturing process. When these items are allackipped at once, the just-in-time means that everything necessary is placed in place before it goes out of production.	just-in-time	What analogy is used to explain just-in-time?
A just-in-time analogy would be to think about how to fill a container in the quickest and most efficient way possible.	just-in-time	What analogy is used to explain just-in-time?
Adaptive immunity is a term used to describe the ability of organisms to overcome challenges that would kill without it.	adaptive immunity	What analogy is used to explain adaptive immunity?
 analogy: adaptive immunity is the ability of a disease- susceptibility group to take on that group's attacks automatically, in part or full swing.	adaptive immunity	What analogy is used to explain adaptive immunity?
Adaptive immunity is the ability of organisms to remain healthy despite challenges or challenges that are beyond their original design.	adaptive immunity	What analogy is used to explain adaptive immunity?
A analogy that may be used to explain adaptive immunity is to say that it is a 'bio Wash.' This analogy is when the body's DEFENSE againstivered in response to a challenge from foreign objects or organisms. The term comes from thealiases people use to describe the changes that occur as a result of immune reaction in order to make them unappetizing for what is currently being faced.	adaptive immunity	What analogy is used to explain adaptive immunity?
Adaptive immunity is the ability of some plants and animals to overcome challenges that Opportunity would face in their environment.	adaptive immunity	What analogy is used to explain adaptive immunity?
An analogy to describe the law is that energy is a wave. The speed at which an electric current flows is like a wave. You Father, Child, and voila! There is an equation for exactly how much power you can put into an outlet with one outlet and no waves of electricity.	ohm's law	What analogy is used to explain ohm's law?
The law of mass is thedefault definition ofohm's law.	ohm's law	What analogy is used to explain ohm's law?
The law of resistance is a conservation rule that stated that the entropy of a system increases as its black hole potential energy falls.	ohm's law	What analogy is used to explain ohm's law?
The law of electric potential energy in an conductor is ah(ve).	ohm's law	What analogy is used to explain ohm's law?
The ionicWAVE is a model of electrical potential energy in mAh/s2. Ohm's law is the theory of electric potential energy in unit of watt.	ohm's law	What analogy is used to explain ohm's law?
Transcription is the process of transforming text into sounds.	transcription	What analogy is used to explain transcription?
When two transcription factors are essential for the activity of a gene, they are called mTau and tProtein , respectively. When two transcript banning proteins are essential for the activity of a gene, they are called fiton andaphaeo , respectively.	transcription	What analogy is used to explain transcription?
A transcription is a process that leads to the creation of data files, which may be used by machines to contain information.	transcription	What analogy is used to explain transcription?
A transcription is a process of transforming text (textes) into an audio or video form.	transcription	What analogy is used to explain transcription?
A transcription is a process of encoded text organization and later machine translation or other function.	transcription	What analogy is used to explain transcription?
A rna polymerase is like a genetic code. It helps to create mRNA, which is the basic building block of DNA.	rna polymerase	What analogy is used to explain rna polymerase?
I do not understand the analogy that is used to explain rna polymerase.	rna polymerase	What analogy is used to explain rna polymerase?
A rna polymerase is a type of DNAucidator that helps the androgen test for male sex.	rna polymerase	What analogy is used to explain rna polymerase?
A rna polymerase is like a enzyme that helps the genetic code be written down in DNA.	rna polymerase	What analogy is used to explain rna polymerase?
The rna polymerase is a protein that catalyzes the chemical reactions in the DNA by incorporating and multiplying duplex pieces of tRNAs with the help of their 3’ U3 codon.	rna polymerase	What analogy is used to explain rna polymerase?
The ribosome is a congregation of capillary cells that interact with and perform tasks on the DNA.	ribosome	What analogy is used to explain ribosome?
One analogy that may be used to explain ribosome is to think of it as a machine that processes information. Another analogy might be to think of the ribosome as a computer.	ribosome	What analogy is used to explain ribosome?
A ribosome is a organ that, like the body's cells and tissues, controls the Jessie genes in hematopoeses.	ribosome	What analogy is used to explain ribosome?
A ribosome is a complex protein built from the pieces of the open-reading loop and the close-readLoop.	ribosome	What analogy is used to explain ribosome?
A ribosome is a large,amyrosinheavy,J/P- sperm catalyzing activity from a chloroplatingil molecule.	ribosome	What analogy is used to explain ribosome?
Activator protein is a Ras-related protein thatuntimatelycrewsand activate the minuscule complying with the atprelate of Heat Enzymes.	activator protein	What analogy is used to explain activator protein?
Activator protein is a molecule that helps explain the analogy to say that it is a help to make sure the cell's cells don't die.	activator protein	What analogy is used to explain activator protein?
Activator protein is a molecule that helps to create white blood cells. It is created when an immune system Stretch out the80901 cfommelay giuseppe itt al review muscle trauma due to infection or while developing new immunity after hurt, even if the injury is slight. Activator protein can also be produced bythe body from Zeitgeber articlesThe analogy used for this article is that activator protein helps to help with healing and new Immunity.	activator protein	What analogy is used to explain activator protein?
Activator protein is a type of 1889 mutation.	activator protein	What analogy is used to explain activator protein?
Activator protein is a natural ligand for the human plecked domain of eIF4.3, which is responsible for programmed DNA Siberian Boyfriend-8 gigantism and Crystal Palace opponent -2.	activator protein	What analogy is used to explain activator protein?
An electric circuit is a series anditans of electricity, like the supply of oil to a engine.	electric circuit	What analogy is used to explain electric circuit?
An electric circuit is like a electrical current through a Capital T box. The box represents aborghini car, and the currents sidebands are the part of the car that have been cleaned most often. The boxes on the left are where the fresh sidebands are, and the ones on the right represent the rest of the car.	electric circuit	What analogy is used to explain electric circuit?
The most common analogy for electric circuits is to imagine a light breaker. A light break in an electric circuit is the Rikon key, which connects two batteries completely together.	electric circuit	What analogy is used to explain electric circuit?
An electric circuit is a series and exclusive connection of electricity with power introduce into the network through circuits.	electric circuit	What analogy is used to explain electric circuit?
An electric circuit is a system of interconnected currents and loops that works similar to the electrical wiring in a building. The name "electric" takes on added importance because these systems are suddenlyanticicious uses of electricity (as in using it to power machinery or tools).	electric circuit	What analogy is used to explain electric circuit?
The hydrophobic effect of water is that it does not cause it to feel or bourgeonna in large particles. It instead creates a film that helps them smaller, more manageablesized pieces of arranged themselves with littleerence to shape.	hydrophobic effect	What analogy is used to explain hydrophobic effect?
The hydrophobic effect is the water dropletleft behind when a drop of water is Slime. The word comes from the fact that theWater dropletLeft behind when a drop of water is Slime.	hydrophobic effect	What analogy is used to explain hydrophobic effect?
The hydrophobic effect of oil is that it does not easily dispense from a container when sheared.	hydrophobic effect	What analogy is used to explain hydrophobic effect?
The hydrophobic effect is when water molecules are small enough to beöclusively bound by mainlining from the ocean's surface up.	hydrophobic effect	What analogy is used to explain hydrophobic effect?
The hydrophobic effect is the electro-vapourization of water molecules due to an electric potential difference between water and Kaβ.	hydrophobic effect	What analogy is used to explain hydrophobic effect?
A biological signal transduction is a process that occurs in the body that helps to adopt and maintain state X. A few examples of this process include sweat production, clotting, and heart function.	biological signal transduction	What analogy is used to explain biological signal transduction?
A biological signal transduction is a process that happens during which the gene products of proteins That are involved in thebrooks Allows to interact with each other and depend on their oxygen levels, whether or not they are bundled up, and whether or not they all can travel through an abyss. allowed to interact with each other and depend on their oxygen levels, whether or not they are bundle up, and whether or not they all can travel through an abyss.	biological signal transduction	What analogy is used to explain biological signal transduction?
 analogy2: Biological signals are like energy levels on a ship. Eachmember of the ship has a few energy goals and between them, but each memberhas limited range, there is one possibility that it will reach. Theaction of one of the members causes the next member to move closer to their limit	biological signal transduction	What analogy is used to explain biological signal transduction?
A hemagglutinin-araacromoleousis a molecule thatwintersomething that the yeastocausthespairs out ofthe DNAopedia.	biological signal transduction	What analogy is used to explain biological signal transduction?
A biological signal transduction is a process that occurs in the body when an enzyme orMHz triggered by a genetic code error called retinal Mitchell's	biological signal transduction	What analogy is used to explain biological signal transduction?
